www.probactive.en.ec21.com	ec21.com
www.customglass.com.uk	com.uk
www.pps.com.za	.za
www.aerialsuperiordesign.vpweb.com	vpweb.com
www.mintbox.com.hypestat.com	hypestat.com
www.6DGlobal.com	6dglobal.com
www.westkentuckyairfreight.bzlnk.com	bzlnk.com
www.nrgyield.com	nrgyield.com
www.sylviaevanscourtreportingservice.lbu.com	lbu.com
www.maaco.com	maaco.com
www.sunset.vetsuite.com	vetsuite.com
www.handrbusinessservice.wordpress.com	wordpress.com
www.bnpr.weebly.com	weebly.com
www.technical-wire-products-llc1.sbcontract.com	sbcontract.com
www.us100718697.fm.alibaba.com	alibaba.com
www.pbatravil.en.ec21.com	ec21.com
www.sivax.com.jp	com.jp
www.merlynp.homestead.com	homestead.com
www.7371927690.brokersite.com	brokersite.com
www.workplaceoptions.com.uk	com.uk
www.jentek-sensors-inc.sbcontract.com	sbcontract.com
www.preferredbrokerage.lbu.com	lbu.com
www.wisdomoflifetherapies.vpweb.com	vpweb.com
www.mwt.com.jp.com	jp.com
www.seals.comcastbiz.net	comcastbiz.net
www.manitowoc.com	manitowoc.com
www.portvilleforestlandsproducts.webstarts.com	webstarts.com
www.vitaltherapies.com	vitaltherapies.com
www.cdscnyc.publishpath.com	publishpath.com
www.tiretechnologies.webs.com	webs.com
etfinfo.rbcgam.com	rbcgam.com
www.yext.com	yext.com
www.harvey-cole-construction-llc.sbcontract.com	sbcontract.com
www.etcu.comop	.comop
www.pnumahealthcare.synthasite.com	synthasite.com
www.ms.asklocalpages.com	asklocalpages.com
www.frohn.openfos.com	openfos.com
www.molten.com.jp	com.jp
www.catalysts.basf.com	basf.com
www.joyobank.com.jp	com.jp
www.elvoxusa.com.com	com.com
www.535limo.homestead.com	homestead.com
www.doh.state.fl.us	state.fl.us
www.olympicliquors.ambz.com	ambz.com
www.mail.stuartdean.com	stuartdean.com
us.spdrs.com	spdrs.com
www.bankofscotland.com.uk	com.uk
www.plancktechnicalservices.vpweb.com	vpweb.com
www.chestermichael.webs.com	webs.com
www.noga.vpweb.com	vpweb.com
www.gdmissionsystems.com	gdmissionsystems.com
www.staffinders.vpweb.com	vpweb.com
www.treeconresources.com	treeconresources.com
www.nm.asklocalpages.com	asklocalpages.com
sheltoncap.com	sheltoncap.com
www.loominus.myshopify.com	myshopify.com
www.aeonlogicartgallery.site90.net	site90.net
www.muus.doitbest.com	doitbest.com
www.agresearch.com.nz	com.nz
www.HF-WA.com	hf-wa.com
www.baycrestanimalclinic.vetsuite.com	vetsuite.com
www.freedomdoor.chiohd.com	chiohd.com
adexa.com	adexa.com
www.cevaleasliving.qwestoffice.net	qwestoffice.net
www.winstonsalem.comforcare.com	comforcare.com
www.rbcpestcontrol.synthasite.com	synthasite.com
www.Krystal.com	krystal.com
www.culver-enterprises-inc.sbcontract.com	sbcontract.com
www.cikuletrucking-public.sharepoint.com	sharepoint.com
www.talisconstruction.weebly.com	weebly.com
www.rdcontractwindowcoverings.thebluebook.com	thebluebook.com
www.progressive.structuredchannel.com	structuredchannel.com
www.seibu-unyu.com.jp.com	jp.com
rvlti.com	rvlti.com
www.qexpresslogistics.ewbz.net	ewbz.net
www.cashlifeinc.weebly.com	weebly.com
www.bop.fm.com	fm.com
www.pocono-property-abstract-inc-stroudsburg-pa.pennsylvania.usa.lawyersdirs.com	lawyersdirs.com
www.valipharm-inc.sbcontract.com	sbcontract.com
www.sc.asklocalpages.com	asklocalpages.com
www.mmtimbertask.vpweb.com	vpweb.com
www.squarespace.com	squarespace.com
www.perfectprintadvertising.espwebsite.com	espwebsite.com
www.sandik-mfg-inc.sbcontract.com	sbcontract.com
www.wildoats.com	wildoats.com
www.cantaffordalawyer.vpweb.com	vpweb.com
www.alphagraphics.com	alphagraphics.com
www.shepitex.squarespace.com	squarespace.com
www.ahcd.webs.com	webs.com
www.sandwichanimalhospital.vetsuite.com	vetsuite.com
www.unitedcp.com	unitedcp.com
www.frankdunaway.pfyfn.com	pfyfn.com
www.topy.com.jp	com.jp
www.us321.alphagraphics.com	alphagraphics.com
www.dbcurtains.samsbiz.com	samsbiz.com
www.svogel.intuitwebsites.com	intuitwebsites.com
www.ednorf.openfos.com	openfos.com
www.jsw.com.jp.com	jp.com
www.lighthousehospicegroup.vpweb.com	vpweb.com
www.cedc.comop	.comop
www.va.asklocalpages.com	asklocalpages.com
www.gnpbkalvingrouptruth.wordpress.com	wordpress.com
www.datamex.com.uk	com.uk
www.brotexinternationalmetals.amlnk.com	amlnk.com
www.archer-aviation-inc.sbcontract.com	sbcontract.com
www.lifetouch.com	lifetouch.com
www.comlorado-county-rice-mill-inc.sbcontract.com	sbcontract.com
www.mikronitet.openfos.com	openfos.com
www.mikespipeinspection.bzlnk.com	bzlnk.com
www.wilco.comop	.comop
www.keycreditcorporation.wisebuyingmall.com	wisebuyingmall.com
www.us-fund.credit-suisse.com	credit-suisse.com
www.eltexfi.openfos.com	openfos.com
www.deerfieldanimalhospital.vetsuite.com	vetsuite.com
www.aaesllc.webs.com	webs.com
www.pella.com	pella.com
www.ffdevotedhomehealthservice.ewbz.net	ewbz.net
publicsecurities.brookfield.com	brookfield.com
www.7322344.usdirectory.com	usdirectory.com
www.hotbagelshop.bravehost.com	bravehost.com
www.1dealer.radio-dealers.com	radio-dealers.com
www.alamo.doitbest.com	doitbest.com
www.freedomenterprises.weebly.com	weebly.com
www.encore-restoration.squarespace.com	squarespace.com
www.bobfosterinc.webs.com	webs.com
www.goodsamaritanretirementhome.lbu.com	lbu.com
www.belloassistedliving.vpweb.com	vpweb.com
www.nm.com	nm.com
www.dndcomm.radio-dealers.com	radio-dealers.com
www.greater-alabama-health-network-inc-tuscaloosa-al.assistance-from-nonprofits.aidpage.com	aidpage.com
www.safeharbor.vpweb.com	vpweb.com
www.cmetro.ctic.com	ctic.com
www.mjcomm.radio-dealers.com	radio-dealers.com
www.banner-overhaul-service.sbcontract.com	sbcontract.com
www.us333.alphagraphics.com	alphagraphics.com
www.twtransfer.energytransfer.com	energytransfer.com
www.btbri.com.com.in	com.in
sprottinc.com	sprottinc.com
www.ardentcommunications.com.uk	com.uk
www.citibank.com	citibank.com
www.nca-machining-llc-shawano-wi.wisconsin.usa.machineshopdir.com	machineshopdir.com
www.investment.prudential.com	prudential.com
www.wtoffshore.com	wtoffshore.com
www.superiorchimneysweeps.webs.com	webs.com
www.sagawa-exp.com.jp.com	jp.com
www.imagedawards.vpweb.com	vpweb.com
www.diamondplatingcompany.ambz.com	ambz.com
www.janulisinc.ddxdental.com	ddxdental.com
www.marvel.com	marvel.com
www.evansvillelithographco.samsbiz.com	samsbiz.com
www.hstrial-jeannestevenson.homestead.com	homestead.com
www.bartonwealthmanagement.wfadv.com	wfadv.com
www.clevelanddowntownlakeside.doubletree.com	doubletree.com
www.leisuretimelawn.wisebuyingmall.com	wisebuyingmall.com
www.lq.com	lq.com
www.en.yachiyo-ind.com.jp	com.jp
www.nesd.dalecarnegie.com	dalecarnegie.com
www.ezlocal.com	ezlocal.com
www.simplicity-gourmet.pissedconsumer.com	pissedconsumer.com
www.metropolitancleaning.cliquesmart.net	cliquesmart.net
www.bun.com.jp.com	jp.com
www.faithmortgagecorp.web-loans.com	web-loans.com
www.ma.asklocalpages.com	asklocalpages.com
www.live.wbbinc.com	wbbinc.com
www.scooter-life.com.uk	com.uk
www.bobfritztrucking.wordpress.com	wordpress.com
www.ak.asklocalpages.com	asklocalpages.com
www.mvo.investorhq.businesswire.com	businesswire.com
www.amfireprotection.thebluebook.com	thebluebook.com
www.drtzepos.optometry.net	optometry.net
www.dpl.vpweb.com	vpweb.com
www.state.tx.us	state.tx.us
www.idesignbusiness.com.ipaddress.com	ipaddress.com
www.hkfgroupinc.directorysgllc.com	directorysgllc.com
www.ibm.com	ibm.com
www.pepper-s-machine-welding-co-inc-bogue-chitto-ms.mississippi.usa.machineshopdir.com	machineshopdir.com
www.pitezelsinkandprint.logomall.com	logomall.com
www.icrossing.com.uk	com.uk
www.careers.milliman.com	milliman.com
www.advancedautoservice.wisebuyingmall.com	wisebuyingmall.com
www.dradeleye.yourmd.com	yourmd.com
www.jb-power.com.jp	com.jp
www.marcumtrucking.wordpress.com	wordpress.com
www.axionofpa.ambz.com	ambz.com
www.internationalbusinesswales.com.uk	com.uk
usa.arcelormittal.com	arcelormittal.com
www.tayiemmd.mymedfusion.com	mymedfusion.com
www.target.com	target.com
www.diversified.instantlender.com	instantlender.com
www.dynasteel.weebly.com	weebly.com
www.craigcooper.productions.com	productions.com
www.plasticsprinting.comcastbiz.net	comcastbiz.net
www.sarahhallimages.photoreflect.com	photoreflect.com
www.us.am.joneslanglasalle.com	joneslanglasalle.com
www.diversetaxllc.vpweb.com	vpweb.com
www.eastransport.weebly.com	weebly.com
www.abqaccidentattorneyllc.vpweb.com	vpweb.com
www.mobell.com.jp	com.jp
www.wepfer-marine-inc.sbcontract.com	sbcontract.com
www.paramountlogistics.listandfound.com	listandfound.com
www.babblingbrook.massagetherapy.com	massagetherapy.com
www.gsgtransport.vzwebsites.com	vzwebsites.com
www.cleantriplec.vpweb.com	vpweb.com
www2.emersonprocess.com	emersonprocess.com
www.turf-maintenance-company-inc.gravelymower.com	gravelymower.com
www.polarisinfrastructure.com	polarisinfrastructure.com
www.kingdomenterprisellc.wordpress.com	wordpress.com
www.bradleytransportation.ethicalaz.com	ethicalaz.com
www.actransport.ethicalaz.com	ethicalaz.com
www.produceworld.com.uk	com.uk
www.nea.comop	.comop
www.dfps.state.tx.us	state.tx.us
www.atlanta.citysearch.com	citysearch.com
www.christianbouknightllc1.vpweb.com	vpweb.com
www.widmanor.openfos.com	openfos.com
www.bolling-gawthrop-law.glfwebhost.com	glfwebhost.com
www.crumps-lawn-garden.gravelymower.com	gravelymower.com
www.chalmurbag.homestead.com	homestead.com
www.pardaycare.webs.com	webs.com
www.raymondiron.webpointusa.com	webpointusa.com
www.vaultstor.openfos.com	openfos.com
www.hathawaypropertymanagementinc.managebuilding.com	managebuilding.com
investment.prudential.com	prudential.com
www.tkfoodservice.openfos.com	openfos.com
www.spruceitup-cleaningservices.mn-biz.com	mn-biz.com
www.bolts-and-nuts-wholesale.a2zyp.com	a2zyp.com
www.aon.com	aon.com
www.mastersbuildersinc.wordpress.com	wordpress.com
www.fheg.follett.com	follett.com
www.gold-rush-manufacturing-limited-bellmore.jewelleryandgemstones.com	jewelleryandgemstones.com
www.crossroadsofjax.tripod.com	tripod.com
www.mid-missouri.hoodz.us.com	hoodz.us.com
www.umicore.com	umicore.com
www.parkhillsmithcooper.lbu.com	lbu.com
www.elgo.com.il	com.il
www.dixierunlabradorpuppies.homestead.com	homestead.com
www.ri.asklocalpages.com	asklocalpages.com
www.garcia-forest-service-llc.sbcontract.com	sbcontract.com
www.gspkcircuits.com.uk	com.uk
www.doorjak.com.ipaddress.com	ipaddress.com
www.karlan-international-inc-dallas.jewelleryandgemstones.com	jewelleryandgemstones.com
tonyromas.com	tonyromas.com
www.castleresorts.com	castleresorts.com
www.benchmarkcorporate.com.uk	com.uk
www.valentine-jewelry-mfg-co-new-york.jewelleryandgemstones.com	jewelleryandgemstones.com
www.statecollege-551.comfortkeepers.com	comfortkeepers.com
www.adlines.freeservers.com	freeservers.com
www.mmp1000.minutemanpress.com	minutemanpress.com
www.northcharlestonuniversityblvdsuites.hamptoninn.com	hamptoninn.com
www.delktechsystems.weebly.com	weebly.com
www.info.win.net	win.net
www.oakland-youth-services-inc-oakland-ca.assistance-from-nonprofits.aidpage.com	aidpage.com
www.fujitsu.com	fujitsu.com
www.gcpotterfieldtrucking.lbu.com	lbu.com
www.highplains.kinetico.com	kinetico.com
www.members.aol.com	aol.com
www.ots.ac.cr.com	cr.com
www.english.kaikaikiki.com.jp.com	jp.com
www.drgraphics.norwood.com	norwood.com
www.qiagen.com	qiagen.com
www.jacksonsofpiccadilly.com.uk	com.uk
www.dresser.com	dresser.com
www.cyberview.com.uk	com.uk
www.east-liverpool-oh.findstoragefast.com	findstoragefast.com
www.clsfinancialservicesinc.jimdo.com	jimdo.com
www.icagroup.comop	.comop
www.amyjacquesgarvey.0catch.com	0catch.com
www.natomasamc.vetsuite.com	vetsuite.com
www.animalclinicofrockbridge.weebly.com	weebly.com
www.sanko-grp.com.jp	com.jp
www.scaffolding.safespan.com	safespan.com
www.b2badvantage.net	b2badvantage.net
www.autumngraphics.on.com	on.com
www.northcauseway.homestead.com	homestead.com
www.centennial-management-services.sbcontract.com	sbcontract.com
www.abditeindustries.openfos.com	openfos.com
www.milleniumhomemortgagecorporation157.vpweb.com	vpweb.com
www.035fced.netsolhost.com	netsolhost.com
www.weehaul.ypgs.net	ypgs.net
www.bluehaven.com	bluehaven.com
www.midatlanticlubes.jiffylube.com	jiffylube.com
www.siemens.com	siemens.com
www.theblesseddaycarecenter.ambz.com	ambz.com
www.schmidtinsuranceagency.wisebuyingmall.com	wisebuyingmall.com
www.mufg.jp	mufg.jp
www.traicor.com.in	com.in
www.omegafine.openfos.com	openfos.com
www.achievementdynamics.sandler.com	sandler.com
ir.iabfinancial.com	iabfinancial.com
www.cuer.comop	.comop
www.jvbonline.com	jvbonline.com
www.md.com	md.com
www.sunexpress.com.th	com.th
www.hospitaltohome.philips.com	philips.com
www.jdchandleraca.wikispaces.com	wikispaces.com
www.tb-kawashima.com.jp	com.jp
www.vetcarecenter.vetstreet.com	vetstreet.com
www.zfamilyenterprisesllc.vzwebsites.com	vzwebsites.com
www.gustavo.photoshelter.com	photoshelter.com
www.chateaudomestics.homestead.com	homestead.com
www.acres.com.com	com.com
www.voyagercontrols.samsbiz.com	samsbiz.com
www.dreamtravelstogo.ambz.com	ambz.com
www.netom-enterprises.sbcontract.com	sbcontract.com
www.leonardgraphics.webs.com	webs.com
www.fastfarmtrailers.vpweb.com	vpweb.com
www.paramount-panels.com.uk	com.uk
www.honolulucoffee.com.jp	com.jp
www.keywestmedicalbilling.vpweb.com	vpweb.com
www.metalspinningsolutions.lbu.com	lbu.com
www.refreshment.aramark.com	aramark.com
www.wawanesaweecare.weebly.com	weebly.com
www.showmelovelearningacademy.4t.com	4t.com
www.tweedymentoring.vpweb.com	vpweb.com
www.invitae.com	invitae.com
www.barwil.com.uk	com.uk
www.ecgleamteam.vpweb.com	vpweb.com
www.webaccess.com.in	com.in
www.casmed.com	casmed.com
www.rajtari.en.ec21.com	ec21.com
www.cincinnati.citysearch.com	citysearch.com
www.jdcd.vpweb.com	vpweb.com
www.headoverheelsboutiques.webs.com	webs.com
www.milfordmass.minutemanpress.com	minutemanpress.com
www.galeyandlord.com	galeyandlord.com
www.cubiconh.openfos.com	openfos.com
www.nht.comcastbiz.net	comcastbiz.net
www.edgewoodmachine.qwestoffice.net	qwestoffice.net
www.hedgehogs.com.za	.za
www.joliet.easterseals.com	easterseals.com
www.bethelsuites.webs.com	webs.com
www.fairbanksresourceagency.wordpress.com	wordpress.com
www.platnumphotography.zenfolio.com	zenfolio.com
www.bgtransport.landstaragent.com	landstaragent.com
www.telechemische.en.ecplaza.net	ecplaza.net
www.bgelevator.openfos.com	openfos.com
www.irvine.advisorsmortgage.com	advisorsmortgage.com
www.maxima991.fm.com	fm.com
www.trager-limestone-llc.sbcontract.com	sbcontract.com
www.floah.vetsuite.com	vetsuite.com
www.pjmurphy.8m.com	8m.com
www.ceraln-corporation.sbcontract.com	sbcontract.com
www.pitstop500.webs.com	webs.com
www.carefirstahoberlin.vetstreet.com	vetstreet.com
www.thefortyork.com.uk	com.uk
www.mgmt.allianceapts.com	allianceapts.com
www.drsawyer.yourmd.com	yourmd.com
www.craconintl.homestead.com	homestead.com
www.cjsqualitybuilding.vpweb.com	vpweb.com
www.us.tuv.com	tuv.com
www.dscreationskrishamarker.homestead.com	homestead.com
www.printing.macdermid.com	macdermid.com
www.videovbox.com.uk	com.uk
www.universal.saint-gobain.com	saint-gobain.com
www.l3t.com	l3t.com
www.southwest-omaha.groundsguys.com	groundsguys.com
www.american-concorde-systems-inc.sbcontract.com	sbcontract.com
www.jcys.embarqspace.com	embarqspace.com
www.scotiabank.com	scotiabank.com
www.capstarbank.com	capstarbank.com
www.msminc.comcastbiz.net	comcastbiz.net
www.mrse.agenthub.net	agenthub.net
www.sarkes-tarzian-incn.fedvendor.com	fedvendor.com
www.aspenalarm.webs.com	webs.com
www.hcc.comop	.comop
www.faro.com	faro.com
www.westernweb.openfos.com	openfos.com
www.amina.procarcarezone.com	procarcarezone.com
www.minutemanpress.com	minutemanpress.com
www.nyse.com	nyse.com
enzon.com	enzon.com
www.halcorp.vpweb.com	vpweb.com
www.milwaukee.bizjournals.com	bizjournals.com
www.tempogroup-org.doodlekit.com	doodlekit.com
www.cafebarcelona.webs.com	webs.com
www.metzler-interiors-inc-harrisonburg-va.virginia.usa.homebuildersdirs.com	homebuildersdirs.com
www.agricheck.openfos.com	openfos.com
www.clc4me.webs.com	webs.com
www.geoproductsllc.stihldealer.net	stihldealer.net
www.kitchellengineering.lbu.com	lbu.com
www.invecastcorp.webyp.net	webyp.net
www.careers.silverleafresorts.com	silverleafresorts.com
www.gettyimages.com.uk	com.uk
www.pembrokebakeryandcafe.wordpress.com	wordpress.com
www.apartment-services-management-inc-auburn-al.alabama.usa.apartmentscondosfinder.com	apartmentscondosfinder.com
www.reboundtowing.weebly.com	weebly.com
www2.emerson.com	emerson.com
www.galeonephoto.photoreflect.com	photoreflect.com
www.flaniganpagano.weebly.com	weebly.com
www.vaugheyvaughey.ambz.com	ambz.com
www.gmk-travel-inc.sbcontract.com	sbcontract.com
www.keymiaee-aero-tech-inc.sbcontract.com	sbcontract.com
www.empowercom-inc.sbcontract.com	sbcontract.com
www.austintxn.expresspros.com	expresspros.com
www.muscmetals.weebly.com	weebly.com
www.btcg.nl.com	nl.com
www.daviseyegroup.homestead.com	homestead.com
www.ovalnext.com.jp.com	jp.com
www.is-usa.bilfinger.com	bilfinger.com
www.drbreedlove.doctorsoffice.net	doctorsoffice.net
www.progressiveprintingmn.webstarts.com	webstarts.com
www.olin-conservation-inc.sbcontract.com	sbcontract.com
www.thosho.openfos.com	openfos.com
www.anthonysairportservice.webs.com	webs.com
www.2u.com	2u.com
www.kua-maui.vpweb.com	vpweb.com
www.medscripts-inc.sbcontract.com	sbcontract.com
www.charlessmithbailbonds.publishpath.com	publishpath.com
www.drbenspivey.wordpress.com	wordpress.com
www.medite-group.com	medite-group.com
www.friendlybowl.bravehost.com	bravehost.com
www.marengocarpetcleaning.vpweb.com	vpweb.com
www.shariflemingphotography.photoreflect.com	photoreflect.com
www.jamescobey.yourmd.com	yourmd.com
www.maple.h2oinnovation.com	h2oinnovation.com
www.universaltreeworks.synthasite.com	synthasite.com
www.africanrefuge.webs.com	webs.com
www.americanrailcar.com	americanrailcar.com
www.myecon.net	myecon.net
www.bhrefrigerationcompany.ethicalaz.com	ethicalaz.com
www.comrporate.discovery.com	discovery.com
www.sdb-consultants-ltd.sbcontract.com	sbcontract.com
www.jhrosecarriers.rmissecure.com	rmissecure.com
www.cal.com.il	com.il
www.q2ebanking.com	q2ebanking.com
www.satx.zippyshell.com	zippyshell.com
www.trinityclimatecontrol.rheemdealer.net	rheemdealer.net
www.jdbank.com	jdbank.com
www.123financialservices.jimdo.com	jimdo.com
www.lazyrtrucking.tripod.com	tripod.com
www.ovationenterprises.wordpress.com	wordpress.com
www.uSell.com	usell.com
www.cargoindustries.com.uk	com.uk
www.doitbest.com	doitbest.com
www.comralreefmed.comcastbiz.net	comcastbiz.net
www.antiekjourneys.webs.com	webs.com
www.activeworld.nyc.com	nyc.com
www.quintus.nl.com	nl.com
www.photronix.com.uk	com.uk
www.kondor-technologies-inc.sbcontract.com	sbcontract.com
www.us379.alphagraphics.com	alphagraphics.com
www.csi.comop	.comop
www.livingstonlaboratories.lbu.com	lbu.com
chuma.us	chuma.us
www.dodsontye-machine-works-inc-magnolia-ar.arkansas.usa.machineshopdir.com	machineshopdir.com
www.usa.baidu.com	baidu.com
www.rrlightingcompany.vzwebsites.com	vzwebsites.com
www.thetravelingbuddha.en.ecplaza.net	ecplaza.net
www.flagshipbanks.com	flagshipbanks.com
www.ct.asklocalpages.com	asklocalpages.com
www.ht-marine-services-inc.sbcontract.com	sbcontract.com
www.wellsfargo.com	wellsfargo.com
www.bayercu.comop	.comop
www.hds.leica-geosystems.com	leica-geosystems.com
www.gfi.retirerx.com	retirerx.com
www.wrihomeserve.webs.com	webs.com
www.addchek-coils-inc.sbcontract.com	sbcontract.com
www.lvrsolutioninc.appraiserxsites.com	appraiserxsites.com
www.dot.state.tx.us	state.tx.us
www.r-and-s-cleaningandmaint.vpweb.com	vpweb.com
www.nrsgroup.com.jp	com.jp
www.nac.nacavi.com.jp	com.jp
www.canyonhillshomecare.vpweb.com	vpweb.com
www.daytonmachine.embarqspace.com	embarqspace.com
www.jbrownvsc.comcastbiz.net	comcastbiz.net
www.lscu.comop	.comop
www.djdonuts.en.ec21.com	ec21.com
www.westsideanimalclinichamilton.vetstreet.com	vetstreet.com
www.hippsoutdoorservices.synthasite.com	synthasite.com
www.independentbank.com	independentbank.com
www.embassysuites.com	embassysuites.com
www.benhartlandscaping.ethicalaz.com	ethicalaz.com
ryu.com	ryu.com
www.grimesfamilyservices.vpweb.com	vpweb.com
www.nv.asklocalpages.com	asklocalpages.com
www.datel.com.uk	com.uk
www.brillc.vpweb.com	vpweb.com
www.quintilesims.com	quintilesims.com
www.jerold-b-katz-foundation.idilogic.aidpage.com	aidpage.com
www.local.ml.com	ml.com
www.ebiz.netopia.com	netopia.com
www.nay.sandler.com	sandler.com
www.voyagervegas.com	voyagervegas.com
www.sp.sandler.com	sandler.com
www.easterseals.com	easterseals.com
www.oceancity.md.com	md.com
www.heservices.com.uk	com.uk
www.pw.utc.com	utc.com
www.cannonhygiene.com.uk	com.uk
www.midco.net	midco.net
www.ohioart.com	ohioart.com
www.amirirealtygroup.homesandland.com	homesandland.com
www.olsonservicesllc.vpweb.com	vpweb.com
www.wfcconstruction.squarespace.com	squarespace.com
www.lkqd.squarespace.com	squarespace.com
www.dmlcorp.weebly.com	weebly.com
www.bankofathens.com.za.com	com.za.com
www.amycenter.mvn.net	mvn.net
www.osb.homestead.com	homestead.com
www.infinityaerospacemfg.com.com	com.com
www.talbert-hotel-corporation.sbcontract.com	sbcontract.com
www.wy.asklocalpages.com	asklocalpages.com
www.gulf-south-piling-constructon.sbcontract.com	sbcontract.com
www.ut.asklocalpages.com	asklocalpages.com
www.wernerdrugstore.epicrx.com	epicrx.com
www.aplusstaffing.lbu.com	lbu.com
www.anotherroomministorageinc.wisebuyingmall.com	wisebuyingmall.com
www.mechanicnet.com	mechanicnet.com
www.facebodyinc.myshopify.com	myshopify.com
www.sbcontract.com	sbcontract.com
www.healthcare.philips.com	philips.com
www.prettypaws.vpweb.com	vpweb.com
www.us.gi-de.com	gi-de.com
www.klc.com.nz.com	nz.com
www.coventryhealthcare.com	coventryhealthcare.com
www.futrelltileinc.wisebuyingmall.com	wisebuyingmall.com
www.gilco-machine-welding-inc-birmingham-al.alabama.usa.machineshopdir.com	machineshopdir.com
www.designerathletic.typepad.com	typepad.com
www.pfyinc.vpweb.com	vpweb.com
www.universaltrucking.vpweb.com	vpweb.com
www.keyang.com.kr	com.kr
www.smmi.com.uk	com.uk
www.dicksteinadvertising.logomall.com	logomall.com
www.trumedia.com.il.com	il.com
www.rosecityneuro.yourmd.com	yourmd.com
www.buildingblocksoftopeka.ambz.com	ambz.com
www.losangeles.citysearch.com	citysearch.com
www.poplaranimalhospital.vetstreet.com	vetstreet.com
www.comnscientiouscleaning.ezlocal.com	ezlocal.com
www.northaire-engineering-manufacturing-llc-lake-mills-ia.iowa.usa.machineshopdir.com	machineshopdir.com
www.lifegate.publishpath.com	publishpath.com
www.arlingtontx.wbu.com	wbu.com
www.niteanddaysecurity.wisebuyingmall.com	wisebuyingmall.com
chiesiusa.com	chiesiusa.com
www.wiljaxinc.photoreflect.com	photoreflect.com
www.business.nasdaq.com	nasdaq.com
www.alltoolpd.openfos.com	openfos.com
investments.pimco.com	pimco.com
www.farrensfinishing.vpweb.com	vpweb.com
www.hattawaymotor.dealerconnection.com	dealerconnection.com
www.adkins.qwestoffice.net	qwestoffice.net
www.upstart.citymax.com	citymax.com
www.mindspring.com	mindspring.com
faircourtassetmgt.com	faircourtassetmgt.com
www.missionviejo-ca-0844.theupsstorelocal.com	theupsstorelocal.com
www.buyimporter.com	buyimporter.com
www.floridaprinting.qpg.com	qpg.com
www.procarcarezone.com	procarcarezone.com
www.curtisamanning2.md.com	md.com
www.rockymountainflagging.lbu.com	lbu.com
www.lhhedgersonsmetalcompany.ambz.com	ambz.com
www.ezfacility.com	ezfacility.com
www.rawlesengineering.tripod.com	tripod.com
www.demco-group-inc.sbcontract.com	sbcontract.com
www.lonquist.squarespace.com	squarespace.com
www.eison-industrial.squarespace.com	squarespace.com
www.navajotransportservices.lbu.com	lbu.com
www.BASinc.com	basinc.com
www.layflat.massagetherapy.com	massagetherapy.com
www.minton.com.uk	com.uk
www.allianceprintinginc.wisebuyingmall.com	wisebuyingmall.com
www.oc.dalecarnegie.com	dalecarnegie.com
www.madeinma.com.cc	com.cc
www.aspire.comnsulting	.comnsulting
www.javelinreit.com	javelinreit.com
www.mission.seniorcarecentersltc.com	seniorcarecentersltc.com
www.roymarketinginc.logomall.com	logomall.com
www.combalt-broadband.pissedconsumer.com	pissedconsumer.com
www.latenssystems.com.uk	com.uk
www.superiorantenna.openfos.com	openfos.com
www.energy.siemens.com	siemens.com
www.thomson.com	thomson.com
www.knoxville.citysearch.com	citysearch.com
www.hmrah.webs.com	webs.com
www.warlickreadymix.intuitwebsites.com	intuitwebsites.com
www.kwgrl1up.en.ec21.com	ec21.com
www.usacomm.comop	.comop
www.brookfield.com	brookfield.com
bbu.brookfield.com	brookfield.com
www.westjaytax.comcastbiz.net	comcastbiz.net
www.shinetsu.com.jp	com.jp
www.axens.net	axens.net
grey.com	grey.com
www.acshmiami.vetstreet.com	vetstreet.com
www.houstonsouth.decoratingden.com	decoratingden.com
www.blue-springs-mo.findstoragefast.com	findstoragefast.com
www.nationalrapid.infinit-i.net	infinit-i.net
www.ifs.portfolioco.com	portfolioco.com
www.targetcustom.weebly.com	weebly.com
www.officialpayments.com	officialpayments.com
www.grsco.wordpress.com	wordpress.com
www.careers.chevron.com	chevron.com
www.stoddardcountytransit.weebly.com	weebly.com
www.tworiverbank.com	tworiverbank.com
www.sanchezlandscaping.weebly.com	weebly.com
www.flywheel.sandler.com	sandler.com
www.maplogistics.landstaragent.com	landstaragent.com
www.teddybearcornerinc.web.officelive.com	officelive.com
www.stx.com.kr	com.kr
www.starfivetransportinconline.vpweb.com	vpweb.com
www.drcolleen.yourmd.com	yourmd.com
www.dardenbobbyinsuranceagency.ambz.com	ambz.com
www.valley-pride-pack-inc.sbcontract.com	sbcontract.com
www.kirbytoledo.homestead.com	homestead.com
www.encore.bz.com	bz.com
www.czmachineinc.comcastbiz.net	comcastbiz.net
www.dalecarnegie.com	dalecarnegie.com
www.bertoluccimanagementinc.homesandland.com	homesandland.com
www.jamescarriers.vpweb.com	vpweb.com
www.modernfreightsolutions.vpweb.com	vpweb.com
www.lumber.doitbest.com	doitbest.com
www.cartermanagementgroup.weebly.com	weebly.com
www.primeraturf.comop	.comop
www.zytek.com.uk	com.uk
www.dforte.en.ecplaza.net	ecplaza.net
www.kesserar.openfos.com	openfos.com
www.eatonvance.com	eatonvance.com
www.follisandsonllc.weebly.com	weebly.com
www.drmichelson.yourmd.com	yourmd.com
www.kuforming.webs.com	webs.com
www.hstrial-bstoltzfus.homestead.com	homestead.com
www.palladinocompany.openfos.com	openfos.com
www.dhs.state.il.us	state.il.us
www.richmondamerican.com	richmondamerican.com
www.cruiseone.com	cruiseone.com
www.jacksonlawncare.vpweb.com	vpweb.com
www.spacesre.wpengine.com	wpengine.com
www.letsgodriving.webs.com	webs.com
www.qad.com	qad.com
www.sugarcreekgardens.wordpress.com	wordpress.com
www.frontiertradingexport.samsbiz.com	samsbiz.com
www.toko.com.jp	com.jp
www.sneeze.yourmd.com	yourmd.com
www.hasenbecki.openfos.com	openfos.com
www.unitedwb.comop	.comop
www.allianceappraisalscorp2.appraiserxsites.com	appraiserxsites.com
www.apurohit.liquidcapitalcorp.com	liquidcapitalcorp.com
www.bcg.bz.com	bz.com
www.lapetiteecolefrancaise.com.uk	com.uk
www.se7en.vpweb.com	vpweb.com
www.andreashammel.ifunnyblog.com	ifunnyblog.com
www.mahle.com	mahle.com
www.horizoncu.comop	.comop
www.automation.siemens.com	siemens.com
www.beavercrossing.vetsuite.com	vetsuite.com
sonexresearch.com	sonexresearch.com
www.theschoolhouse.homestead.com	homestead.com
www.koidekokan.com.jp	com.jp
www.anchmedsurg.weebly.com	weebly.com
www.greystar-electronics-inc.sbcontract.com	sbcontract.com
www.hms.com	hms.com
www.greatsouthbay.seatow.com	seatow.com
www.comrbettsworld.wordpress.com	wordpress.com
www.woodhamsford.dealerconnection.com	dealerconnection.com
www.archant.com.uk	com.uk
www.pac.com.uk	com.uk
www.robert-clear-coal-corp.sbcontract.com	sbcontract.com
www.medfordplating.webs.com	webs.com
www.as.l-3com.com	l-3com.com
www.sites.google.com	google.com
www.stryker.com	stryker.com
www.orasa.openfos.com	openfos.com
investors.cinemark.com	cinemark.com
www.titanmachinery.com	titanmachinery.com
www.fingerprintcardslivescan.vpweb.com	vpweb.com
www.ladyanne.openfos.com	openfos.com
www.comuntrysideveterinaryhospital.vetsuite.com	vetsuite.com
www.fedvendor.com	fedvendor.com
www.gaddisinc.wordpress.com	wordpress.com
www.pkkwealthmanagement.wfadv.com	wfadv.com
www.thepineforest.wordpress.com	wordpress.com
www.cnv-service-company-llc.sbcontract.com	sbcontract.com
www.tmcnet.com	tmcnet.com
www.hurricanepainclinic.webs.com	webs.com
www.muench.photoshelter.com	photoshelter.com
www.cffarm.name.com	name.com
www.winstedareachildcarecenter.weebly.com	weebly.com
www.turningpointcounselingabilene.blogsp.com	blogsp.com
www.hesseknipps.openfos.com	openfos.com
www.strategiclending.wordpress.com	wordpress.com
www.ezrotational.en.ec21.com	ec21.com
www.duray-machine-co-inc-lorain-oh.ohio.usa.machineshopdir.com	machineshopdir.com
www.imperial.com.za	.za
www.seawardcareers.silkroad.com	silkroad.com
www.ohshiningcorp.en.ecplaza.net	ecplaza.net
www.dallas.dalecarnegie.com	dalecarnegie.com
www.oce.com	oce.com
www.3087878407.brokersite.com	brokersite.com
www.mvgllc.webs.com	webs.com
www.investorrelations.ibankpeoples.com	ibankpeoples.com
www.manhattantravel.tv.com	tv.com
www.summerfield.ks.phonepagesinc.com	phonepagesinc.com
www.netwerx.inc.com	inc.com
www.webpointusa.com	webpointusa.com
www.bcr.en.taiwantrade.com	taiwantrade.com
www.ruota.comnsulting	.comnsulting
www.tec.comop	.comop
www.libardiandsonlandscaping.vpweb.com	vpweb.com
www.millbrookschool.vpweb.com	vpweb.com
www.ana.com.jp.com	jp.com
www.hernando-ms.findstoragefast.com	findstoragefast.com
longsrx.com	longsrx.com
www.tjslawncare.vpweb.com	vpweb.com
www.btsusa.openfos.com	openfos.com
www.southendservices.webs.com	webs.com
www.goodworksintl.com.com	com.com
www.oceanlogistics.com.uk	com.uk
www.spokane-central.itex.com	itex.com
www.classicjewelry.weebly.com	weebly.com
www.jal.com	jal.com
www.agp.logomall.com	logomall.com
www.nc.asklocalpages.com	asklocalpages.com
www.dbjetenterprises.qwestoffice.net	qwestoffice.net
www.legveins.md.com	md.com
www.piedmonthaulers.landstaragent.com	landstaragent.com
www.doonerorganicsinc.vpweb.com	vpweb.com
www.goovaerts.pierre.googlepages.com	googlepages.com
www.nbdiscoveryacademy.wordpress.com	wordpress.com
www.kaseya.com.nz.com	nz.com
www.gtc.moonfruit.com	moonfruit.com
www.jet-neko.com	jet-neko.com
www.lpl.com	lpl.com
www.paragon-logistics.com.il	com.il
www.fpsflawfirm.com	fpsflawfirm.com
www.waco.tnol.com	tnol.com
www.jonesrealestateappraisalservicesinc.appraiserxsites.com	appraiserxsites.com
corporate.discovery.com	discovery.com
www.gillette.com	gillette.com
www.diaco.com.uk	com.uk
www.impark.com	impark.com
www.stihldealer.net	stihldealer.net
www.tabco.logomall.com	logomall.com
www.ternium.com	ternium.com
www.sterilatorny.openfos.com	openfos.com
gi.guggenheiminvestments.com	guggenheiminvestments.com
www.ahi.vpweb.com	vpweb.com
www.pif.com.uk	com.uk
www.capitolacquisition.com	capitolacquisition.com
www.newjerseymining.com	newjerseymining.com
investor.williams.com	williams.com
www.northtampa.nmfn.com	nmfn.com
www.amog.comnsulting	.comnsulting
www.nyegoldseekers.webs.com	webs.com
www.tmpil.openfos.com	openfos.com
www.igorkravchenko.metrolistpro.com	metrolistpro.com
www.advertising.microsoft.com	microsoft.com
www.urdan.com.il.com	il.com
www.bishopgroupinc.webs.com	webs.com
www.multimediafarms.wordpress.com	wordpress.com
www.rollertraders.vpweb.com	vpweb.com
www.smartbusinessconsulting.lbu.com	lbu.com
www.marret.ca	marret.ca
www.propsychservices.vpweb.com	vpweb.com
www.franchise.moneymailer.com	moneymailer.com
www.brightbeginningearlychild.lbu.com	lbu.com
www.gobgobinc.wordpress.com	wordpress.com
www.aui.vpweb.com	vpweb.com
www.bullardson.openfos.com	openfos.com
www.badgercryogenics.qpg.com	qpg.com
www.jancoentprises.bloombiz.com	bloombiz.com
www.kiriu.com.jp	com.jp
www.lutz.q10capital.com	q10capital.com
www.asteriasbiotherapeutics.com	asteriasbiotherapeutics.com
www.carolinascustomcladinc.amlnk.com	amlnk.com
www.ishares.com	ishares.com
www.augusta.trojanlabor.com	trojanlabor.com
www.nco-financial-systems.pissedconsumer.com	pissedconsumer.com
www.southernpipelineconstruction.wisebuyingmall.com	wisebuyingmall.com
www.fairfield.minutemanpress.com	minutemanpress.com
pgntgroup.com	pgntgroup.com
www.prestige-printing.com.uk	com.uk
www.epistem.com.uk	com.uk
www.sharpspring.com	sharpspring.com
www.proformawtb.logomall.com	logomall.com
www.midway-machine-welding-inc-burleson-tx.texas.usa.machineshopdir.com	machineshopdir.com
www.firstam.com	firstam.com
www.hertz.com	hertz.com
www.slgreen.com	slgreen.com
www.lapierreelectronics.lbu.com	lbu.com
www.karinghands.lbu.com	lbu.com
www.hhbindery.openfos.com	openfos.com
www.willowbrookmanorinc.youronlineservices.net	youronlineservices.net
www.inpex.com.jp	com.jp
www.de.asklocalpages.com	asklocalpages.com
www.thecleaningauthority.com	thecleaningauthority.com
www.essabank.com	essabank.com
www.acecleaningcompany.com.uk	com.uk
www.fuji-silysia.com.jp	com.jp
www.phoenix011.alphagraphics.com	alphagraphics.com
www.norwich-ct.findstoragefast.com	findstoragefast.com
www.firstbank.bz.com	bz.com
www.uvc.com.jp	com.jp
www.megamet.amlnk.com	amlnk.com
www.ipublish.travelhost.com	travelhost.com
www.greatflorida.com	greatflorida.com
www.heavenlyspirits.jimdo.com	jimdo.com
www.mccomblumber.wordpress.com	wordpress.com
www.sourcefire.com	sourcefire.com
www.nwsanantoniotx.expresspros.com	expresspros.com
www.synpep.lookchem.com	lookchem.com
www.centralfl.kinetico.com	kinetico.com
www.bonneville.q10capital.com	q10capital.com
www.logistics.en.ec21.com	ec21.com
www.windowgenie.com	windowgenie.com
www.allcaringhomehealthservices.embarqspace.com	embarqspace.com
www.bignall.com.uk	com.uk
www.pcua.comop	.comop
www.metlife.com	metlife.com
www.pmcdevelopment.webs.com	webs.com
www.com.asklocalpages.com	asklocalpages.com
www.polyram.com.il	com.il
www.nashville.bizjournals.com	bizjournals.com
www.alliedortho.squarespace.com	squarespace.com
www.geniejanitorial.homestead.com	homestead.com
www.inspirus.com	inspirus.com
www.rjo.wisebuyingmall.com	wisebuyingmall.com
www.corporate.yod.com	yod.com
www.meridianassetservices.homestead.com	homestead.com
www.norkin-jewelry-mfg-inc-chicago.jewelleryandgemstones.com	jewelleryandgemstones.com
www.mikesplum.mechanicnet.com	mechanicnet.com
www.comgnex.com.uk	com.uk
am.jpmorgan.com	jpmorgan.com
www.fms.com.il	com.il
tax.thomsonreuters.com	thomsonreuters.com
www.dailypost.com.uk	com.uk
www.nwindianapolis.kaplancollege.com	kaplancollege.com
breathecig.com	breathecig.com
www.firsttimehomebuyers101.com.com	com.com
www.hstrial-rhower2.homestead.com	homestead.com
www.comuntryside.minutemanpress.com	minutemanpress.com
www.chattanoogacupcakes.comcastbiz.net	comcastbiz.net
www.bizjournals.com	bizjournals.com
www.westindy.firstlighthomecare.com	firstlighthomecare.com
www.worcester.yalwa.com	yalwa.com
www.onleyicecream.embarqspace.com	embarqspace.com
www.schwegleraaa.wordpress.com	wordpress.com
www.turtlebeach.com	turtlebeach.com
www.quicken.intuit.com	intuit.com
www.thefootdoctors.wordpress.com	wordpress.com
www.landcargoinc.services.officelive.com	officelive.com
www.home.trident-design.com	trident-design.com
www.trisign.homestead.com	homestead.com
www.lycos.com.kr	com.kr
www.soma.com.uk	com.uk
www.oh.asklocalpages.com	asklocalpages.com
www.cherrygroveanimalhospital.vetstreet.com	vetstreet.com
www.demeo-construction-corp.marlton.xnewjersey.com	xnewjersey.com
www.pmc-marketing-group-inc.sbcontract.com	sbcontract.com
www.kaneenvironmental.50megs.com	50megs.com
www.westex.comop	.comop
westmorelandmlp.com	westmorelandmlp.com
www.renaissancers.openfos.com	openfos.com
www.net.com	net.com
www.reedacademy.homestead.com	homestead.com
www.knorr-bremse.com.in	com.in
www.allpoints.comop	.comop
www.sanfrancisco.axa-advisors.com	axa-advisors.com
www.medrx.com.jp	com.jp
www.taylorsecurityenterprises.weebly.com	weebly.com
www.gladstonecommercial.com	gladstonecommercial.com
www.landsolutionsgroup.vpweb.com	vpweb.com
www.monical-rea-inc-clute-tx.texas.usa.buildingcontractorsdirs.com	buildingcontractorsdirs.com
www.superpostalcenter.homestead.com	homestead.com
www.comgitic.comcastbiz.net	comcastbiz.net
etfus.deutscheam.com	deutscheam.com
www.mo.asklocalpages.com	asklocalpages.com
ewww.guggenheiminvestments.com	guggenheiminvestments.com
www.kohls.com	kohls.com
www.lclandscapeservicesllc.googlepages.com	googlepages.com
www.cruiseadventuretravel.agenthub.net	agenthub.net
www.infonet.com	infonet.com
www.he.net	he.net
www.beanwood.eventbrite.com	eventbrite.com
www.bmg.wfadv.com	wfadv.com
www.sb.northropgrumman.com	northropgrumman.com
www.joneslanglasalle.com	joneslanglasalle.com
www.lambertvillehardware.doitbest.com	doitbest.com
www.aeropartners.com.jp	com.jp
www.adkinsonthorne.weebly.com	weebly.com
www.us.issworld.com	issworld.com
www.sandbearexpress.landstaragent.com	landstaragent.com
www.mjbconstruction.wordpress.com	wordpress.com
www.soundsgreat.jimdo.com	jimdo.com
www.lifepics.com	lifepics.com
www.prioritytowing.homestead.com	homestead.com
www.diamondatransporters.vpweb.com	vpweb.com
www.plcca.homestead.com	homestead.com
www.miami.citysearch.com	citysearch.com
www.me.asklocalpages.com	asklocalpages.com
www.stopbyus.en.ec21.com	ec21.com
www.refuserescues.lbu.com	lbu.com
www.jdolsen.cruiseone.com	cruiseone.com
www.steelmillfabricators.weebly.com	weebly.com
www.gracemobility.pridedealer.com	pridedealer.com
www.delwintransfer.lbu.com	lbu.com
www.rockitcargo.com	rockitcargo.com
www.weedmanusa.com	weedmanusa.com
www.austinp.fedvendor.com	fedvendor.com
www.diversity-solutions-inc.sbcontract.com	sbcontract.com
www.southridgeadvisorsllc.wordpress.com	wordpress.com
www.parkertie.doitbest.com	doitbest.com
www.rymeg.openfos.com	openfos.com
www.reliablecleaning.vpweb.com	vpweb.com
www.investor.fnf.com	fnf.com
www.leeschools.net	leeschools.net
www.lanesassistedliving.vpweb.com	vpweb.com
www.gdarleneandersonlaw.petrasite.com	petrasite.com
www.comforcare.com	comforcare.com
www.chicago.suntimes.com	suntimes.com
www.fairwaytire.mechanicnet.com	mechanicnet.com
www.cpm.homesandland.com	homesandland.com
www.littlerock.citysearch.com	citysearch.com
www.dngcleaningservices.homestead.com	homestead.com
www.easybusinessforms.logomall.com	logomall.com
www.premierphotomall.lifepics.com	lifepics.com
www.cdtltd.com.uk	com.uk
www.comnstruction.com	comnstruction.com
www.kingdom.fm.com	fm.com
www.ituscorp.com	ituscorp.com
www.qca.qualcomm.com	qualcomm.com
www.officeally.com	officeally.com
www.mainstream.vpweb.com	vpweb.com
www.arcadis-us.com.com	com.com
www.netscape.com	netscape.com
www.wauchula.greatflorida.com	greatflorida.com
www.ocuease.weebly.com	weebly.com
www.iray.nextlot.com	nextlot.com
www.avon-group.com.uk	com.uk
www.slickoperatingservices.listandfound.com	listandfound.com
www.silverstationpromotions.norwood.com	norwood.com
www.owensurveying.tripod.com	tripod.com
www.kepco.com.jp	com.jp
www.cpdelectronics.en.ec21.com	ec21.com
www.taylorsrainbowlearning.lbu.com	lbu.com
www.truegrittruckbrokers.weebly.com	weebly.com
www.bay-sand-company-inc.sbcontract.com	sbcontract.com
www.destinmachine.embarqspace.com	embarqspace.com
www.planitinc.wordpress.com	wordpress.com
www.TimkenSteel.com	timkensteel.com
www.mika-electric-inc-naples-fl.florida.usa.homebuildersdirs.com	homebuildersdirs.com
www.hilotrailerparts.webs.com	webs.com
www.springcreekhomes.webs.com	webs.com
www.il.asklocalpages.com	asklocalpages.com
www.marysville-374.comfortkeepers.com	comfortkeepers.com
www.national.citysearch.com	citysearch.com
www.stpetersseniorcitizencorp.lbu.com	lbu.com
www.aroa.yourmd.com	yourmd.com
www.asahi-america.com	asahi-america.com
www.3m.com	3m.com
www.alsincorporated.intuitwebsites.com	intuitwebsites.com
www.5596352225.clinicapps.com	clinicapps.com
www.ipeco.com.uk	com.uk
www.horneyscustomcycles.embarqspace.com	embarqspace.com
www.comnstitutionlandsurveying.ambz.com	ambz.com
www.pelen-engineering-inc-signal-hill-ca.california.usa.machineshopdir.com	machineshopdir.com
www.ar.asklocalpages.com	asklocalpages.com
www.skymarc.en.ec21.com	ec21.com
www.southsidelearning.vpweb.com	vpweb.com
www.blantonsupplies.doitbest.com	doitbest.com
www.cm.natixis.com	natixis.com
www.eastgeorgia.radio-dealers.com	radio-dealers.com
www.ajaxrents.managebuilding.com	managebuilding.com
www.almooradianperformance.lbu.com	lbu.com
www.delansonfireco.wordpress.com	wordpress.com
www.koidekokan.com.jp.com	jp.com
redalertgroup.com	redalertgroup.com
www.cifloors.wordpress.com	wordpress.com
www.ais.homestead.com	homestead.com
www.mtinnasheville.homestead.com	homestead.com
www.broadcoinc.vpweb.com	vpweb.com
www.aurora-group-telecom-llc.sbcontract.com	sbcontract.com
www.newtrenddesign.webs.com	webs.com
www.oubreanimalclinic.vetsuite.com	vetsuite.com
www.capper.easterseals.com	easterseals.com
www.advision.com.jp.com	jp.com
www.denitrab.smugmug.com	smugmug.com
www.us451.alphagraphics.com	alphagraphics.com
www.cme.comop	.comop
www.ballon-landa.yourmd.com	yourmd.com
www.dawsonappraisalinc.appraiserxsites.com	appraiserxsites.com
www.us.sandoz.com	sandoz.com
www.ottertailcoaches.tripod.com	tripod.com
www.jrfrazier.openfos.com	openfos.com
www.picccentral.vpweb.com	vpweb.com
www.terramarepartners.openfos.com	openfos.com
www.q10capital.com	q10capital.com
www.ethicalaz.com	ethicalaz.com
www.allied-telesis.com.jp	com.jp
www.jayhawkpm.managebuilding.com	managebuilding.com
www.footstepsmartinsville.webs.com	webs.com
www.ecologicfoam.homestead.com	homestead.com
www.investments.voya.com	voya.com
www.yardstick-decor.tripod.com	tripod.com
www.fourinone.com.uk	com.uk
www.churchill.q10capital.com	q10capital.com
www.diversified-metals.sbcontract.com	sbcontract.com
www.nacityboyssanitation.wisebuyingmall.com	wisebuyingmall.com
www.young-ladies-first-corporation-port-st-lucie-fl.assistance-from-nonprofits.aidpage.com	aidpage.com
www.douglastrunnell.guideone.com	guideone.com
www.intelifx.openfos.com	openfos.com
www.us.hsbc.com	hsbc.com
www.trend-tool-inc.sbcontract.com	sbcontract.com
www.us241.alphagraphics.com	alphagraphics.com
ingomoney.com	ingomoney.com
www.amor-bakery-no-2.dinehere.us	dinehere.us
www.powertech.com.kr.com	com.kr.com
www.stiksnballs.weebly.com	weebly.com
www.guionpartners.wordpress.com	wordpress.com
www.gbscience.com	gbscience.com
www.focalprecisionoptometry.jimdo.com	jimdo.com
www.milwaukee.citysearch.com	citysearch.com
www.newcountry.dealerconnection.com	dealerconnection.com
www.enrich.photoreflect.com	photoreflect.com
www.itochu.com.jp	com.jp
www.etfs.bmo.com	bmo.com
www.nemontanahealthservices.homestead.com	homestead.com
www.pfeiffer-vacuum.com	pfeiffer-vacuum.com
www.heartwoodcw.wordpress.com	wordpress.com
www.rockymgl.openfos.com	openfos.com
www.brodheadanimalhospitalpc.vetsuite.com	vetsuite.com
www.travelleaders.com	travelleaders.com
www.aandamotorwerkes.repair.bz.com	bz.com
www.mercurytaxservice.wisebuyingmall.com	wisebuyingmall.com
www.motherlode-provisions.myshopify.com	myshopify.com
www.mjphotosofnwi.photoreflect.com	photoreflect.com
www.cjsexpressbrokerage.vpweb.com	vpweb.com
www.seminerals-public.sharepoint.com	sharepoint.com
www.professionalmovingandstorage.weebly.com	weebly.com
www.westernindustrialmachining.ambz.com	ambz.com
www.jmorgansigns.wordpress.com	wordpress.com
www.bankleumi.com.il	com.il
www.mmwd.tripod.com	tripod.com
www.proven-choice-machining-inc-sanford-me.maine.usa.machineshopdir.com	machineshopdir.com
www.whitlockellis.wfadv.com	wfadv.com
www.impactimages.photoreflect.com	photoreflect.com
www.minkinchandler.weebly.com	weebly.com
www.dallas391.alphagraphics.com	alphagraphics.com
www.directgeneral.com	directgeneral.com
www.goppert-foundation.idilogic.aidpage.com	aidpage.com
www.greenbrierm.openfos.com	openfos.com
www.lostinthetreesatunderbelly.eventbrite.com	eventbrite.com
www.hstrial-sblomberg.intuitwebsites.com	intuitwebsites.com
www.freqelec.com	freqelec.com
www.maldeneyecare.comcastbiz.net	comcastbiz.net
www.mjpromotions.espwebsite.com	espwebsite.com
www.americanincline.openfos.com	openfos.com
www.acoustiguide.com.il	com.il
www.viking-lumber-company-inc.sbcontract.com	sbcontract.com
www.brooklynbread.com.za	.za
www.5starservicegroup.weebly.com	weebly.com
www.texas.aaa.com	aaa.com
www.comntempolendin.web-loans.com	web-loans.com
www.burbankpediatrics.yourmd.com	yourmd.com
www.powdersvilleah.vetstreet.com	vetstreet.com
www.marcusbarrministries.synthasite.com	synthasite.com
www.comnnollys.doitbest.com	doitbest.com
www.bartaanimalhospital.vetstreet.com	vetstreet.com
www.theupsstorelocal.com	theupsstorelocal.com
www.nisshin-steel.com.jp	com.jp
www.cdcwilmington.wordpress.com	wordpress.com
www.proadvisor.intuit.com	intuit.com
www.111homepersonalcareagency.weebly.com	weebly.com
www.lbennettdesign.homestead.com	homestead.com
www.lehighacres.greatflorida.com	greatflorida.com
www.gatewaycounseling.webs.com	webs.com
www.greatbend.abbeycarpet.com	abbeycarpet.com
www.eclipsecoffeeandtea.weebly.com	weebly.com
www.logan.abbeycarpet.com	abbeycarpet.com
www.baucomscanvas.webs.com	webs.com
www.judithradau.ifunnyblog.com	ifunnyblog.com
www.dowaship.com.jp	com.jp
www.lakehavasucity-697.comfortkeepers.com	comfortkeepers.com
www.johnsonpublications.zenfolio.com	zenfolio.com
www.enterprises-inc69.sbcontract.com	sbcontract.com
www.glacier-tech.com	glacier-tech.com
www.customcaremanagement.vpweb.com	vpweb.com
us.vwr.com	vwr.com
www.halifax.com.uk	com.uk
www.diamondlogistics.com.uk	com.uk
www.synergy-machine-inc-kent-wa.washington.usa.machineshopdir.com	machineshopdir.com
www.amey.com.uk	com.uk
www.evergreenpeds.yourmd.com	yourmd.com
www.kkrausemd.yourmd.com	yourmd.com
www.kaylergeoscience.homestead.com	homestead.com
www.genesee.comop	.comop
www.southernoklahomaeyecenter.ewbz.net	ewbz.net
www.springfield.firstlighthomecare.com	firstlighthomecare.com
www.mokocoffee.typepad.com	typepad.com
www.netsource.com.uk	com.uk
www.dars.state.tx.us	state.tx.us
www.sylvanlearning.com	sylvanlearning.com
www.2.rtpatterson.com	rtpatterson.com
www.jacobpatternworks.openfos.com	openfos.com
www.ultraseal.com.uk	com.uk
semlerscientific.com	semlerscientific.com
investor.shentel.com	shentel.com
www.myfederalcreditunion.comop	.comop
rljlodgingtrust.com	rljlodgingtrust.com
www.comncretecreations.homestead.com	homestead.com
ir.firstcash.com	firstcash.com
www.childrenskingdom.webs.com	webs.com
www.nikkinet.com.jp	com.jp
www.herewegrowacademy.weebly.com	weebly.com
www.wa.asklocalpages.com	asklocalpages.com
www.ecopetplastics.en.ec21.com	ec21.com
www.bronzeway.openfos.com	openfos.com
www.remingtonfinancialgroup1.wordpress.com	wordpress.com
www.minastravel.lbu.com	lbu.com
www.nrucfc.comop	.comop
www.silverlakewealth.wfadv.com	wfadv.com
www.rlhpaint.openfos.com	openfos.com
www.galliameigscaa.webs.com	webs.com
www.charlotte.citysearch.com	citysearch.com
www.kansascity.citysearch.com	citysearch.com
www.bonappetit.openfos.com	openfos.com
www.citycoolcorp.rheemdealer.net	rheemdealer.net
www.mcfallphysicaltherapy.lbu.com	lbu.com
www.foster.com.jp	com.jp
www.ntt.com	ntt.com
new.abb.com	abb.com
www.ennislawncare.vpweb.com	vpweb.com
www.kmalik.yourmd.com	yourmd.com
www.spokanepostalcu.comop	.comop
www.peters-design-group-inc.sbcontract.com	sbcontract.com
www.springleaf.com	springleaf.com
www.syracuse.citysearch.com	citysearch.com
www.bransonsashanddoor.lbu.com	lbu.com
www.simmonsbank.com	simmonsbank.com
www.isagenix.com	isagenix.com
www.ecoservices.lbu.com	lbu.com
www.britton.k12.sd.us	k12.sd.us
www.scott-wellington-ltd-inc.sbcontract.com	sbcontract.com
www.corbinhill.openfos.com	openfos.com
www.careers-relfm.icims.com	icims.com
www.s-w-machine-works-inc-alsip-il.illinois.usa.machineshopdir.com	machineshopdir.com
www.goodbuddiescabinets.lbu.com	lbu.com
www.limo-services-minneapolis.mn-biz.com	mn-biz.com
www.ncfe.comop	.comop
www.healthyme.md.com	md.com
www.kinglithographers.openfos.com	openfos.com
www.peakcorrosion.openfos.com	openfos.com
www.freedomvillagenh.comop	.comop
www3.troweprice.com	troweprice.com
www.satis-incny.sbcontract.com	sbcontract.com
www.mi.asklocalpages.com	asklocalpages.com
www.hstrial-aheim.homestead.com	homestead.com
www.ImageWorksCorporation.com	imageworkscorporation.com
www.nichicon.com.jp	com.jp
www.lysanderfunds.com	lysanderfunds.com
www.venell.openfos.com	openfos.com
www.sueapepperscpa.intuitwebsites.com	intuitwebsites.com
www.fullsalestraining.sandler.com	sandler.com
www.tetley.com.uk	com.uk
www.texas.focalpointcoaching.com	focalpointcoaching.com
www.soluchem.en.ec21.com	ec21.com
investments.voya.com	voya.com
www.investments.pimco.com	pimco.com
www.mowing4missions.vpweb.com	vpweb.com
www.twincities.citysearch.com	citysearch.com
www.ftn.fedex.com	fedex.com
www.assured-injection-mold-inc-saint-louis-mo.missouri.usa.machineshopdir.com	machineshopdir.com
www.fidelity.com	fidelity.com
www.thomasnet.com	thomasnet.com
www.vanguard.com	vanguard.com
www.pliskascreativekitchens.jimdo.com	jimdo.com
www.behrakis-foundation.idilogic.aidpage.com	aidpage.com
www.medicinova.com	medicinova.com
www.investors.floridacommunitybank.com	floridacommunitybank.com
www.ranchwood.vetsuite.com	vetsuite.com
www.sagebrook.seniorcarecentersltc.com	seniorcarecentersltc.com
www.rew-corporation.sbcontract.com	sbcontract.com
www.advancedconsultingtechnologyinc.wisebuyingmall.com	wisebuyingmall.com
www.eagle-integrated-controls-inc-ashland-va.virginia.usa.securitysystemsdir.com	securitysystemsdir.com
www.debcor-inc.sbcontract.com	sbcontract.com
www.bradhostetler.wordpress.com	wordpress.com
www.bethel-machine-manufacturing-inc-bethel-park-pa.pennsylvania.usa.machineshopdir.com	machineshopdir.com
www.hintonhumancapital.wordpress.com	wordpress.com
www.lloydstsb.com.uk	com.uk
www.yahoo.com	yahoo.com
www.northsidevet.vetsuite.com	vetsuite.com
www.spiraltoys.com	spiraltoys.com
www.climatecontrol.wisebuyingmall.com	wisebuyingmall.com
www.tx.asklocalpages.com	asklocalpages.com
www.tdrealestate.managebuilding.com	managebuilding.com
www.workersolutions.vpweb.com	vpweb.com
www.rsiparts.wordpress.com	wordpress.com
www.baseinstallations.weebly.com	weebly.com
www.karls.doitbest.com	doitbest.com
www.ljllee.qwestoffice.net	qwestoffice.net
www.hpinteriorsolutions.ezlocal.com	ezlocal.com
www.123shine1.vpweb.com	vpweb.com
www.katlenco.wordpress.com	wordpress.com
www.anninosurvey.webs.com	webs.com
www.yorknationalease.ambz.com	ambz.com
www.us.henry.com	henry.com
www.nordstrom.com	nordstrom.com
www.rlm.vpweb.com	vpweb.com
www.usaencore.chinaexporter.com	chinaexporter.com
www.walmart.com	walmart.com
www.pruttingandcompany.wordpress.com	wordpress.com
www.bdmanagementco.managebuilding.com	managebuilding.com
www.budgetcleaningservice.webs.com	webs.com
www.westsideanimalclinic.vetsuite.com	vetsuite.com
www.uptown.intlminutepress.com	intlminutepress.com
www.afernandezcrane.webs.com	webs.com
www.name.com	name.com
www.angelwoodautosafety.lbu.com	lbu.com
www.us.sgs.com	sgs.com
www.sparta-mi.findstoragefast.com	findstoragefast.com
www.signonsandiego.com	signonsandiego.com
www.sabre-tec-incorporated.sbcontract.com	sbcontract.com
www.kycul.comop	.comop
www.clearwaterfl.expresspros.com	expresspros.com
www.supremecg.openfos.com	openfos.com
www.wappingersfalls.abbeycarpet.com	abbeycarpet.com
www.sappi.com	sappi.com
www.absconsulting.com.jp.com	jp.com
www.otrpermits.wordpress.com	wordpress.com
www.us.ibm.com	ibm.com
www.naa-services-corporation.sbcontract.com	sbcontract.com
www.stricklandsp.openfos.com	openfos.com
www.selmaair.bravehost.com	bravehost.com
www.atlascapitalholdings.wordpress.com	wordpress.com
www.grace.vpweb.com	vpweb.com
www.reserve.refinery29.com	refinery29.com
www.ppscontrol.qwestoffice.net	qwestoffice.net
www.nwm.wfadv.com	wfadv.com
www.dixiemkt.logomall.com	logomall.com
www.paltrustcu.comop	.comop
www.digitalfuelcapital.squarespace.com	squarespace.com
www.ausd-ca.schoolloop.com	schoolloop.com
www.paperct.tripod.com	tripod.com
www.magiclandchildcare.weebly.com	weebly.com
www.nichirin.com.jp	com.jp
www.ojedamultiservicescorp.jimdo.com	jimdo.com
www.rlbpropertyservices.weebly.com	weebly.com
www.penngoldwellservices.weebly.com	weebly.com
www.templetx.expresspros.com	expresspros.com
www.kindermorgan.com	kindermorgan.com
www.blueridge.comop	.comop
www.rdmarketingllc.openfos.com	openfos.com
www.kbahonline.vetsuite.com	vetsuite.com
www.kiddintl.com	kiddintl.com
www.durham-metaltech-inc-durham-ca.california.usa.machineshopdir.com	machineshopdir.com
www.roswellhardware.doitbest.com	doitbest.com
www.eugene21.en.ec21.com	ec21.com
www.blcommunications.radio-dealers.com	radio-dealers.com
www.tpnnbeautyinc.webs.com	webs.com
www.johnsonlanematerials.weebly.com	weebly.com
harvestportfolios.com	harvestportfolios.com
www.food.us.rhodia.com	rhodia.com
www.kauzlaric-richard.sbcontract.com	sbcontract.com
www.nextstar.dealer.sprint.com	sprint.com
www.precisionadmin.publishpath.com	publishpath.com
www.vetstreet.com	vetstreet.com
www.hanall.com.kr	com.kr
www.charlestons.ehsrg.com	ehsrg.com
www.sml.state.tx.us	state.tx.us
www.hstrial-beneastman.homestead.com	homestead.com
www.intellicheck.com	intellicheck.com
www.packetvideo.com.jp.com	jp.com
www.criss-optical-manufacturing-co.sbcontract.com	sbcontract.com
www.OfficialPayments.com	officialpayments.com
www.royalpalmbeach.greatflorida.com	greatflorida.com
www.18dollareyeglassesplace.wordpress.com	wordpress.com
www.taylorengineering.lbu.com	lbu.com
www.jal.com.jp	com.jp
www.hilton.com	hilton.com
www.gbs-security-systems-inc.sbcontract.com	sbcontract.com
www.ahcfacilities.com	ahcfacilities.com
www.west-davie-power-equipment.gravelymower.com	gravelymower.com
www.swat.comop	.comop
www.advantagesintered.com	advantagesintered.com
newsroom.united.com	united.com
www.ricksairport.openfos.com	openfos.com
www.nelsonalarms.ypgs.net	ypgs.net
www.us.kaeser.com	kaeser.com
www.pontchartrain.vetsuite.com	vetsuite.com
www.calamos.com	calamos.com
www.kroum.openfos.com	openfos.com
www.acoustic-energy.com.uk	com.uk
www.prosites-jsashc.homestead.com	homestead.com
www.sullivan-trail-legal-society-inc-elmira-ny.assistance-from-nonprofits.aidpage.com	aidpage.com
www.elitemedicalconsultants.vpweb.com	vpweb.com
www.breakingchainsinc.vpweb.com	vpweb.com
www.eventbrite.com	eventbrite.com
www.garnerlandscapingandlawncare.weebly.com	weebly.com
www.aafwd.mechanicnet.com	mechanicnet.com
www.golehr.com	golehr.com
www.capitalonecoatings.vpweb.com	vpweb.com
www.mikestowing.wordpress.com	wordpress.com
www.cabreraservices.lbu.com	lbu.com
www.hutchinson-ks.findstoragefast.com	findstoragefast.com
www.5points.massagetherapy.com	massagetherapy.com
www.raven.com.uk	com.uk
www.glendale.ahcfacilities.com	ahcfacilities.com
www.crossroads-eye-care.yourmd.com	yourmd.com
www.cjb.net	cjb.net
www.porta-target-inc.sbcontract.com	sbcontract.com
www.riversedge-peds.yourmd.com	yourmd.com
www.fusioninc.com.jp	com.jp
www.direct-dispensing-inc1.sbcontract.com	sbcontract.com
www.fslending.autopal.info	autopal.info
seer-corp.com	seer-corp.com
www.jonesmemoriallibrary.wordpress.com	wordpress.com
www.jsa-tool-engineering-inc-sturtevant-wi.wisconsin.usa.machineshopdir.com	machineshopdir.com
www.jiffylube.com	jiffylube.com
www.parkside.citymax.com	citymax.com
www.taiun.com.jp	com.jp
www.trinitybiosurgical.weebly.com	weebly.com
www.checkpointsystems.com	checkpointsystems.com
www.acc.com.nz	com.nz
www.neilcopeland.photoreflect.com	photoreflect.com
www.fieldphotography.photoreflect.com	photoreflect.com
www.ir.comnsolidated.com	comnsolidated.com
www.redcarpetinn.wisebuyingmall.com	wisebuyingmall.com
www.biopeptides.openfos.com	openfos.com
www.zcardna.com.com	com.com
www.aol.com	aol.com
www.alaska-connex.sbcontract.com	sbcontract.com
www.bayviewent.homestead.com	homestead.com
www.lifebridgetechnologies.synthasite.com	synthasite.com
www.nutramed2010.en.ec21.com	ec21.com
www.stlouis.comforcare.com	comforcare.com
www.exteriorscapeinc.wisebuyingmall.com	wisebuyingmall.com
www.flowcontrolpl.fatcow.com	fatcow.com
www.tennessee-apparel-corp.sbcontract.com	sbcontract.com
www.home.comcast.net	comcast.net
www.kloosterboer.nl.com	nl.com
www.mosquitosquad.com	mosquitosquad.com
www.birdsinc.webs.com	webs.com
corporate.stage.com	stage.com
www.robertsulli.yourmd.com	yourmd.com
www.corporate.yp.com	yp.com
www.shawfloors.com	shawfloors.com
www.stlaveres.weebly.com	weebly.com
www.synergeticsh.openfos.com	openfos.com
www.da-systems.com.uk	com.uk
senestech.com	senestech.com
www.thecreatorstouch.vpweb.com	vpweb.com
www.comrbinhill.openfos.com	openfos.com
personal.vanguard.com	vanguard.com
www.prime.comcastbiz.net	comcastbiz.net
www.engineering.quest-global.com	quest-global.com
www.brookswellservice.homestead.com	homestead.com
www.timoniumanimalhospital.vetsuite.com	vetsuite.com
www.7341404590.brokersite.com	brokersite.com
www.lowellma.expresspros.com	expresspros.com
www.kboenterprises.lbu.com	lbu.com
www.midlandanimalclinic.vetsuite.com	vetsuite.com
www.shoom.com	shoom.com
www.jaguar-precision-machine-corp.sbcontract.com	sbcontract.com
www.animalhospitalofrushville.vetsuite.com	vetsuite.com
www.usa.onyx-healthcare.com	onyx-healthcare.com
www.sa-ind.com.il	com.il
www.stopandshop.com	stopandshop.com
www.bluedotpromotions.norwood.com	norwood.com
www.artisan-specialist-tech-inc.sbcontract.com	sbcontract.com
www.gardentitle.vpweb.com	vpweb.com
www.rikenkaki.com.jp	com.jp
www.sekido.com.jp	com.jp
www.lantrix.en.ec21.com	ec21.com
www.moreheadanimal.vetstreet.com	vetstreet.com
www.delta-cable.tripod.com	tripod.com
www.technicalmaterials.umicore.com	umicore.com
www.erkmann.yourmd.com	yourmd.com
www.ermek.en.ec21.com	ec21.com
www.cascadephysicaltherapy.lbu.com	lbu.com
www.manpower.com	manpower.com
www.americansprinklercorp.comcastbiz.net	comcastbiz.net
www.1981.usna.com	usna.com
www.american-sports-medical-industries-inc-corning-ar.arkansas.usa.machineshopdir.com	machineshopdir.com
www.alejandrobarrero.ifunnyblog.com	ifunnyblog.com
co.williams.com	williams.com
www.malvernpowerequipmentinc.stihldealer.net	stihldealer.net
www.myflorida.com	myflorida.com
www.stationdigital.com	stationdigital.com
www.priceconsultingengineers.thebluebook.com	thebluebook.com
www.superior-boat-works-inc.sbcontract.com	sbcontract.com
www.hartech.openfos.com	openfos.com
www.kk-toyoshima.com.jp	com.jp
www.hfm.comcastbiz.net	comcastbiz.net
www.hstrial-starenterprises.intuitwebsites.com	intuitwebsites.com
www.crowriverfamilyservices.wordpress.com	wordpress.com
www.mid-atlantic.dalecarnegie.com	dalecarnegie.com
www.honeyvet.vetsuite.com	vetsuite.com
www.freerealtime.com	freerealtime.com
www.broadbent.com.uk	com.uk
www.marketinginteractions.typepad.com	typepad.com
www.hillsborofoodpantry.webs.com	webs.com
www.omega-container-inc.sbcontract.com	sbcontract.com
www.dulcedesigns.photoreflect.com	photoreflect.com
www.afh.cascades.com	cascades.com
www.fujitrans.openfos.com	openfos.com
www.cardospizza-spirits.ezlocal.com	ezlocal.com
www.us587.alphagraphics.com	alphagraphics.com
www.houstontx.expresspros.com	expresspros.com
www.abb.com	abb.com
www.laguardialandscapellc.social-circle.com	social-circle.com
www.cristinamullenpsychotherapycoachingandconsultings1.vpweb.com	vpweb.com
www.angelinard.homestead.com	homestead.com
www.emergencyrestoration.wisebuyingmall.com	wisebuyingmall.com
www.zalmylangsam.en.ec21.com	ec21.com
www.energy.atincorporated.com	atincorporated.com
www.higginsandspencer.hdwfg.com	hdwfg.com
www.txkservices.wordpress.com	wordpress.com
www.albanytransport.com.nz.com	nz.com
www.suburbanobgyn.yourmd.com	yourmd.com
www.alanstransport.freeservers.com	freeservers.com
www.bluesource.com.uk	com.uk
www.starshinetravel.webs.com	webs.com
www.superiorfmfl.openfos.com	openfos.com
www.crosscountry.bizland.com	bizland.com
www.ir.primeacq.com	primeacq.com
www.kasphul-corporation-new-york.jewelleryandgemstones.com	jewelleryandgemstones.com
astonhill.ca	astonhill.ca
www.carrier.com	carrier.com
finance.cat.com	cat.com
www.trs.state.tx.us	state.tx.us
www.cite-corporation.sbcontract.com	sbcontract.com
www.allegiancestaffing.com	allegiancestaffing.com
www.etrade.com	etrade.com
www.carlosinteriors.hdwfg.com	hdwfg.com
www.twdinteriors.squarespace.com	squarespace.com
www.thetreat.com.com	com.com
www.strongtowertransportcorp.weebly.com	weebly.com
www.centerplayersofbayonne.4t.com	4t.com
www.familyservice.weebly.com	weebly.com
www.moreymovingandstorage.vpweb.com	vpweb.com
www.familydentalcare.comcastbiz.net	comcastbiz.net
www.l-3com.com	l-3com.com
www.chrisregister.vpweb.com	vpweb.com
www.vetsuite.com	vetsuite.com
www.kern.com.uk	com.uk
www.boehringer-ingelheim.com	boehringer-ingelheim.com
www.sankei-gk.com.jp	com.jp
www.land-restoration-inc.sbcontract.com	sbcontract.com
www.alabamagraphite.com	alabamagraphite.com
www.eastcoastmobilehealth.intuitwebsites.com	intuitwebsites.com
www.kirbycorp.com	kirbycorp.com
www.swagelok.com	swagelok.com
www.photoreflect.com	photoreflect.com
www.mmpinc2.qwestoffice.net	qwestoffice.net
www.westcoastappliance.brandsource.com	brandsource.com
www.noruscai.com.uk	com.uk
www.communityanimalclinic.vetstreet.com	vetstreet.com
www.lucymckie.postlets.com	postlets.com
www.alwaysjkmobiledetailing.webs.com	webs.com
www.mn.asklocalpages.com	asklocalpages.com
www.litco-machine-products-inc-stanton-ca.california.usa.machineshopdir.com	machineshopdir.com
www.comlleyville.actikare.com	actikare.com
www.miamisubs.com	miamisubs.com
www.billsbattery.lbu.com	lbu.com
www.britlink.com	britlink.com
www.toenta.com.jp	com.jp
clubmonaco.borderfree.com	borderfree.com
www.commercialmobile.ypgs.net	ypgs.net
www.airrobotics.wordpress.com	wordpress.com
www.simplysockyarn.typepad.com	typepad.com
www.artdistrictcigars.webs.com	webs.com
waxman.com	waxman.com
www.massmarketinginc.wisebuyingmall.com	wisebuyingmall.com
www.fortwayne.actikare.com	actikare.com
www.bossgloves.com	bossgloves.com
www.lawrencebergman.yourmd.com	yourmd.com
www.handsonoriginals.logomall.com	logomall.com
www.mmworldtravel.vacationport.net	vacationport.net
www.nationwide.com.uk	com.uk
www.southwestkustoms.bmbnow.com	bmbnow.com
www.lfh-concepts.pissedconsumer.com	pissedconsumer.com
www.innovativeproductsusa.vpweb.com	vpweb.com
www.mrpipesinc.wordpress.com	wordpress.com
www.csartsgroup.wordpress.com	wordpress.com
www.cciwh.yourmd.com	yourmd.com
www.military-waste-management-inc.sbcontract.com	sbcontract.com
ww2.infocrossing.com	infocrossing.com
www.zbarten.openfos.com	openfos.com
www.westgeorgia.easterseals.com	easterseals.com
www.ky.asklocalpages.com	asklocalpages.com
www.vermiculiteproductsinc.weebly.com	weebly.com
www.happyheartschristianchildcare.blogsp.com	blogsp.com
www.beneross.en.ec21.com	ec21.com
www.dictator.com.uk	com.uk
www.frontierwirelesscorporation.vpweb.com	vpweb.com
www.gordonexcavating.vpweb.com	vpweb.com
www.watchfuleyeoptical.vpweb.com	vpweb.com
www.rsl.com.il	com.il
www.heluesd-k12-pt.schoolloop.com	schoolloop.com
www.drharish.yourmd.com	yourmd.com
www.springvalley.househunt.com	househunt.com
www.rocklin.abbeycarpet.com	abbeycarpet.com
www.comlorado.ctic.com	ctic.com
www.davisonindex.mihomepaper.com	mihomepaper.com
www.3cordlogistics.intuitwebsites.com	intuitwebsites.com
www.norwood.com	norwood.com
www.heavenlyplayhouse.vpweb.com	vpweb.com
fxi.com	fxi.com
www.wix.com	wix.com
www.communitychildcarecenter.weebly.com	weebly.com
www.madison470.alphagraphics.com	alphagraphics.com
assetmanagement.gs.com	gs.com
www.holoxtechnologiesf.openfos.com	openfos.com
www.germainsoftware.com	germainsoftware.com
www.3lazyjphoto.photoreflect.com	photoreflect.com
www.photoshelter.com	photoshelter.com
www.ntrmetals.com.uk	com.uk
www.portfolio.primerica.com	primerica.com
www.evolutionpowertools.com.uk	com.uk
www.w-republicservices-com.netsolads.com	netsolads.com
www.brownsvilletx.expresspros.com	expresspros.com
www.truesleep.intuitwebsites.com	intuitwebsites.com
www.bi.com	bi.com
www.moretelwireless.lbu.com	lbu.com
www.qualitywaste.tripod.com	tripod.com
www.packetvideo.com.jp	com.jp
www.sea.siemens.com	siemens.com
www.grrasp-inc.sbcontract.com	sbcontract.com
www.ameristarsignadgraphix.ambz.com	ambz.com
www.robinsonadultdaysvc.webs.com	webs.com
www.ournationsenterprise.samsbiz.com	samsbiz.com
www.en.annec.com.cn	annec.com.cn
www.ir.teladoc.com	teladoc.com
www.thetrainingcenter.sandler.com	sandler.com
www.rrpi.en.ec21.com	ec21.com
www.alcatel-lucent.com	alcatel-lucent.com
www.gutteling.nl.com	nl.com
www.landgtrucking.weebly.com	weebly.com
www.deatons.homestead.com	homestead.com
us.pioneerinvestments.com	pioneerinvestments.com
www.us371.alphagraphics.com	alphagraphics.com
www.jdstowing.vpweb.com	vpweb.com
www.comrrpro.com.uk	com.uk
www.genesure.com.za	.za
www.southtexascommunitymedical.webstarts.com	webstarts.com
www.dishcountry.getdish.com	getdish.com
www.owencogis.weebly.com	weebly.com
www.aon.com.za	.za
www.franchisedirect.com.uk	com.uk
www.kre8ivetanz.vpweb.com	vpweb.com
www.lassetertractorcoinc.stihldealer.net	stihldealer.net
www.holterfinancialgroup.nmfn.com	nmfn.com
www.deitschandroyer.verizonsupersite.com	verizonsupersite.com
www.grewaltrans.weebly.com	weebly.com
etf.jhinvestments.com	jhinvestments.com
www.littletonpawsanimalhospital.vetsuite.com	vetsuite.com
www.kellydesign.com.uk	com.uk
www.minn-dakasphalt.lbu.com	lbu.com
www.good4kidzlearningctdaycare.vpweb.com	vpweb.com
www.ccsmed.com	ccsmed.com
www.cassistravel.com.uk	com.uk
www.thesilverstonehome.intuitwebsites.com	intuitwebsites.com
civitas-solutions.com	civitas-solutions.com
www.movings4u.vpweb.com	vpweb.com
www.wiicorporate.qwestoffice.net	qwestoffice.net
www.nouveaugraphics.logomall.com	logomall.com
www.haverhilldaycare.webs.com	webs.com
www.us.army.mil	army.mil
www.majeskimachine.homestead.com	homestead.com
www.dumpsterrentalwestchester.ny-biz.com	ny-biz.com
na.sage.com	sage.com
www.northstartech.wordpress.com	wordpress.com
www.moneywise.com.uk	com.uk
www.dssimon.com	dssimon.com
www.mjwesselsmoving.wordpress.com	wordpress.com
www.burlingtonpethospital.vetsuite.com	vetsuite.com
www.wm.com	wm.com
www.globtek.com	globtek.com
www.iccaustin.comop	.comop
www.kneadtoescape.massagetherapy.com	massagetherapy.com
www.stlouisdowntown.embassysuites.com	embassysuites.com
www.neilton-landscaping-inc.sbcontract.com	sbcontract.com
www.tatetruckbrokerage.landstaragent.com	landstaragent.com
\www.libertyhealthcare.com	libertyhealthcare.com
www.theceratogroup.wfadv.com	wfadv.com
www.doublebeeenterprisesinc.samsbiz.com	samsbiz.com
www.americanmortgagereliefservicesseminar.wordpress.com	wordpress.com
www.shepherd-stainless.vcn.com	vcn.com
radiantdelivers.com	radiantdelivers.com
www.unocomm.com.uk	com.uk
www.cart.rrcycles.com	rrcycles.com
www.kameisdies.lbu.com	lbu.com
www.caleblancinsurance.comcastbiz.net	comcastbiz.net
www.airewellnessspa.abmp.com	abmp.com
www.sirsidynix.com	sirsidynix.com
individualinvestor.myleggmason.com	myleggmason.com
www.equalexchange.comop	.comop
www.atyourservicesoutheast.com.cc	com.cc
www.dsmeal.cruisesinc.com	cruisesinc.com
www.siegersmithinc.vpweb.com	vpweb.com
www.iwatabolt.com.jp	com.jp
www.dr7.homestead.com	homestead.com
www.lakewoodvet.vetsuite.com	vetsuite.com
www.rnl.com.kr.com	com.kr.com
www.compustar.openfos.com	openfos.com
www.child-care-amenity-group-inc-costa-mesa-ca.assistance-from-nonprofits.aidpage.com	aidpage.com
www.jewishseniorliving.publishpath.com	publishpath.com
www.williams.com	williams.com
www.savemore.doitbest.com	doitbest.com
www.carlmshapirodo.doctorsoffice.net	doctorsoffice.net
www.robertsonauto.com	robertsonauto.com
www.milwaukee.maidbrigade.com	maidbrigade.com
www.metro-waste-systems-inc.sbcontract.com	sbcontract.com
www.handhgraphics.logomall.com	logomall.com
www.hendersontruckinginc.vpweb.com	vpweb.com
www.dananddeans.vpweb.com	vpweb.com
corp.ign.com	ign.com
www.petespielman.weebly.com	weebly.com
www.hiltongardeninn.hilton.com	hilton.com
www.ir.greatwesternbank.com	greatwesternbank.com
www.nwb.com.jp	com.jp
www.warrdaalyenterprisesllc.vpweb.com	vpweb.com
www.sowega.ning.com	ning.com
www.elvesatwork.weebly.com	weebly.com
www.agilent.com	agilent.com
www.iccirlallc.planetsoho.com	planetsoho.com
www.wisebuyingmall.com	wisebuyingmall.com
www.inphot-inc.sbcontract.com	sbcontract.com
www.paulicooling.openfos.com	openfos.com
www.savagelandcompany.lbu.com	lbu.com
www.stephenlelsberryara2.appraiserxsites.com	appraiserxsites.com
www.nmfn.com	nmfn.com
www.fhb.com	fhb.com
www.models.fordmodels.com	fordmodels.com
www.permapipe.com	permapipe.com
www.pugetsoundbank.com	pugetsoundbank.com
www.cadrianwhite.vpweb.com	vpweb.com
www.firstprioritypreservation.weebly.com	weebly.com
www.pennymacfinancial.com	pennymacfinancial.com
www.comnsultrix.com.uk	com.uk
www.triplenetinvestments.managebuilding.com	managebuilding.com
aytubio.com	aytubio.com
www.web.walkerdunlop.com	walkerdunlop.com
www.minacs.adityabirla.com	adityabirla.com
www.eca-eaec.com	eca-eaec.com
www.the-plant-people.myshopify.com	myshopify.com
www.lscprecision.embarqspace.com	embarqspace.com
www.winterautollc.wordpress.com	wordpress.com
www.austin.bizjournals.com	bizjournals.com
www.pctelcom.comop	.comop
www.comlumbusgraphics.openfos.com	openfos.com
www.idaka.com.jp	com.jp
www.scm.propertyware.com	propertyware.com
www.rcjones.comcastbiz.net	comcastbiz.net
www.ansei.com.jp	com.jp
www.absolutetours.weebly.com	weebly.com
www.premiercommercial.thebluebook.com	thebluebook.com
www.us.ishares.com	ishares.com
www.okasan.com.jp.com	jp.com
www.webs.com	webs.com
www.kyocera.com	kyocera.com
www.service1st.vpweb.com	vpweb.com
www.hmg.md.com	md.com
www.handishop-industries-inc.sbcontract.com	sbcontract.com
www.mktgcomm.logomall.com	logomall.com
www.myriadrbm.com	myriadrbm.com
www.financialservicesinc.ubs.com	ubs.com
www.scharnweber.kinetico.com	kinetico.com
truenorthreit.com	truenorthreit.com
www.caainfo2.homestead.com	homestead.com
www.megator.com.uk	com.uk
www.marleyfinancialgroup.retirerx.com	retirerx.com
www.tmcsllc.vpweb.com	vpweb.com
www.promowest.logomall.com	logomall.com
www.availability.sungard.com	sungard.com
www.investors.univision.net	univision.net
brsresources.com	brsresources.com
www.jmiinc.intuitwebsites.com	intuitwebsites.com
www.anncorporation.bloombiz.com	bloombiz.com
www.shenpacoindustries.vpweb.com	vpweb.com
www.amazingcreations.vpweb.com	vpweb.com
www.mdbillinggroup.vpweb.com	vpweb.com
www.shr.fiberpipe.net	fiberpipe.net
www.whiteriveraggredate.ypgs.net	ypgs.net
guggenheiminvestments.com	guggenheiminvestments.com
www.jacksonville.citysearch.com	citysearch.com
www.classicerosion.webpointusa.com	webpointusa.com
www.guardiantitlecorporation.wisebuyingmall.com	wisebuyingmall.com
www.mgic.com	mgic.com
www.hudmet.bizhosting.com	bizhosting.com
www.firstlighthomecare.com	firstlighthomecare.com
www.lancerprecision.itgo.com	itgo.com
www.locations.ubm.com	ubm.com
www.ccia.com.nz.com	nz.com
www.angerstruckinginc.tripod.com	tripod.com
www.fusionpartnerships.wordpress.com	wordpress.com
www.deltaic.openfos.com	openfos.com
www.torchpromos.espwebsite.com	espwebsite.com
www.lockson.com.uk	com.uk
www.villagereader.bravehost.com	bravehost.com
www.piresearch.com.uk	com.uk
greateastenergy.com	greateastenergy.com
www.associatedwm.openfos.com	openfos.com
www.toyotomi-kiko.com.jp	com.jp
www.cwfc.com	cwfc.com
www.services-inc18.sbcontract.com	sbcontract.com
www.doubletree1.hilton.com	hilton.com
www.healthfirstchiro.mychiroblog.com	mychiroblog.com
www.lyco.com.uk	com.uk
www.corporate-wennermedia.icims.com	icims.com
www.tbforms.logomall.com	logomall.com
www.carmichael-sons-inc-independence-mo.missouri.usa.findlandscapecontractors.com	findlandscapecontractors.com
www.cfbankonline.com	cfbankonline.com
www.gencoshipping.com	gencoshipping.com
www.tmbesq.webs.com	webs.com
www.ellenhohmllc.vpweb.com	vpweb.com
www.pollotropical.com	pollotropical.com
www.southjersey.aaa.com	aaa.com
www.westpalmbeach2.greatflorida.com	greatflorida.com
www.id.asklocalpages.com	asklocalpages.com
www.nationalfireprotection.webs.com	webs.com
pipeportal.kindermorgan.com	kindermorgan.com
www.qualityfeed.webs.com	webs.com
www.westchestercounty.maidbrigade.com	maidbrigade.com
www.summitiny.openfos.com	openfos.com
www.huntsville.minutemanpress.com	minutemanpress.com
www.topnotchtaxservice.vpweb.com	vpweb.com
www.fsfr.fifthstreetfinance.com	fifthstreetfinance.com
www.karpos.com.jp.com	jp.com
www.jabometals.homestead.com	homestead.com
www.midmichigansportswear.weebly.com	weebly.com
www.baywa-re.com.uk	com.uk
www.empire.state.ny.us	state.ny.us
www.everettmemorials.embarqspace.com	embarqspace.com
www.us.selex-es.com.com	com.com
www.sandwichfactory.weebly.com	weebly.com
www.kachinsushi.weebly.com	weebly.com
www.pendletontrailerservice.wisebuyingmall.com	wisebuyingmall.com
investor.usrareearths.com	usrareearths.com
www.cremedelfeme.webs.com	webs.com
interstatehotels.com	interstatehotels.com
www.terrellspotatochips.webs.com	webs.com
www.touchstoneappraisal.appraiserxsites.com	appraiserxsites.com
www.tamaki.com.nz	com.nz
www.mariahlimousine.homestead.com	homestead.com
adverum.com	adverum.com
www.platinumsatellitellc.getdish.com	getdish.com
www.ad-ininc.vpweb.com	vpweb.com
www.blueridgesoftware.bz.com	bz.com
www.00ec167.netsolhost.com	netsolhost.com
www.tjr-enterprises-inc.sbcontract.com	sbcontract.com
www.ibide-international-corporation.sbcontract.com	sbcontract.com
www.poinciana.fl.phonepagesinc.com	phonepagesinc.com
www.xltproperty.managebuilding.com	managebuilding.com
www.rpstatuary.webs.com	webs.com
www.kn-lawn-service-inc.sbcontract.com	sbcontract.com
www.oxford-nc.findstoragefast.com	findstoragefast.com
www.brookfield-wi-1431.theupsstorelocal.com	theupsstorelocal.com
www.eiwamm.com.jp	com.jp
www.scott.com.nz	com.nz
www.minorexpress.vpweb.com	vpweb.com
www.epsontoyocom.com.jp	com.jp
www.intercommunitynurseryschool.weebly.com	weebly.com
www.special-tool-solutions-inc-jacksonville-fl.florida.usa.machineshopdir.com	machineshopdir.com
www.tyler.tx.tnol.com	tnol.com
www.aaadiscountselfstorage.vpweb.com	vpweb.com
www.wk101262913.company.weiku.com	weiku.com
www.soken-inc.com.jp	com.jp
www.dshs.state.tx.us	state.tx.us
www.plus.google.com	google.com
www.spatron.openfos.com	openfos.com
www.tensilica.com.jp.com	jp.com
www.japex.com.jp	com.jp
www.eaglefishingtools.weebly.com	weebly.com
www.whc-sc.com.com	com.com
www.s1.com	s1.com
www.globalaw.com.il.com	il.com
www.hartig-industries-inc-columbus-oh.ohio.usa.machineshopdir.com	machineshopdir.com
www.issworld.com	issworld.com
www.members.tripod.com	tripod.com
www.moracares.homestead.com	homestead.com
www.americanmaint.jimdo.com	jimdo.com
www.pennantplc.com.uk	com.uk
www.wesa.fm.com	fm.com
www.airwarelabs.com	airwarelabs.com
www.beronicasalazar.wordpress.com	wordpress.com
www.lmj.managebuilding.com	managebuilding.com
www.deborahslittleshepherds.homestead.com	homestead.com
www.narberth.pa.phonepagesinc.com	phonepagesinc.com
www.texasrecharge.listandfound.com	listandfound.com
www.axsome.com	axsome.com
www.mugzz11.en.ec21.com	ec21.com
www.aronehardware.doitbest.com	doitbest.com
www.cintel.com.uk	com.uk
www.users.qwest.net	qwest.net
www.vatech.com.uk	com.uk
www.doctordave.chiroweb.com	chiroweb.com
www.jeroldivie.remax.com	remax.com
www.kroproductions.openfos.com	openfos.com
avantdiagnostics.com	avantdiagnostics.com
www.teucriumtagsfund.com	teucriumtagsfund.com
www.adulthomecarellc.webs.com	webs.com
www.bankofamerica.com	bankofamerica.com
www.the-emotion.com.jp	com.jp
www.jarvisincinerator.vpweb.com	vpweb.com
investors.bankatunion.com	bankatunion.com
www.terumo.com.jp	com.jp
www.vst.com.jp	com.jp
www.car-part.com	car-part.com
www.majeske-machine-inc-plymouth-mi.michigan.usa.machineshopdir.com	machineshopdir.com
www.greenwood-sc-1775.theupsstorelocal.com	theupsstorelocal.com
www.fantasytours-travel.webs.com	webs.com
www.hstrial-taracolopy.intuitwebsites.com	intuitwebsites.com
www.spectrumpromotions.norwood.com	norwood.com
www.hi-boy-group-inck.fedvendor.com	fedvendor.com
www.topsoiltrucking.vzwebsites.com	vzwebsites.com
www.stanco-tool-die-inc.sbcontract.com	sbcontract.com
www.executiveservices.vpweb.com	vpweb.com
www.3d.sandler.com	sandler.com
www.allstarfoam.qwestoffice.net	qwestoffice.net
www.fifthstreetfinance.com	fifthstreetfinance.com
www.andersonmwi814.openfos.com	openfos.com
www.comromant.sandvik.com	sandvik.com
www.dougtheelectrician.webs.com	webs.com
www.whadleyprintinginc00.b2badvantage.net	b2badvantage.net
www.pacificsafeport.openfos.com	openfos.com
www.fresno-fabtech-inc-fresno-ca.california.usa.buildingcontractorsdirs.com	buildingcontractorsdirs.com
www.margatie.vpweb.com	vpweb.com
www.qualityseafood.wordpress.com	wordpress.com
www.khilnaniwm.wfadv.com	wfadv.com
www.waltshardware.doitbest.com	doitbest.com
www.chehalis.abbeycarpet.com	abbeycarpet.com
www.ambush34.tripod.com	tripod.com
www.albanycomm.radio-dealers.com	radio-dealers.com
www.deanstevenson.photoshelter.com	photoshelter.com
www.checkpointweldin.qwestoffice.net	qwestoffice.net
www.khprinters.invitations.com	invitations.com
www.briarwoodah.vetstreet.com	vetstreet.com
www.comloradochassis.ezlocal.com	ezlocal.com
www.dupagekane.maidbrigade.com	maidbrigade.com
www.advancedhealth1.weebly.com	weebly.com
www.barberosacyclesllc.wisebuyingmall.com	wisebuyingmall.com
www.nobonz.openfos.com	openfos.com
www.peytonplace.vpweb.com	vpweb.com
www.lblfinancial.wfadv.com	wfadv.com
www.battlefieldwp.openfos.com	openfos.com
www.stalwartfilms.com.uk	com.uk
www.octagonaero.com	octagonaero.com
www.netcomuk.com.uk	com.uk
www.jerrystowing.lbu.com	lbu.com
www.sapient.com	sapient.com
www.anderson.minutemanpress.com	minutemanpress.com
www.fiskars.com	fiskars.com
www.twinvee.com	twinvee.com
www.firstopinion.4t.com	4t.com
www.timothysicecream.weebly.com	weebly.com
www.englertassets.auctivacommerce.com	auctivacommerce.com
www.touchbase.com.uk	com.uk
www.promark.logomall.com	logomall.com
www.paid-corp.com	paid-corp.com
www.96d737a5ee0f4c39b4d519b649e4c9ca.sites.yp.com	yp.com
www.dennis-j--kehoe-a-law-corporation-aptos-ca.california.usa.lawyersdirs.com	lawyersdirs.com
www.amipromo.logomall.com	logomall.com
www.fannemblem.logomall.com	logomall.com
www.tbseng.com.uk	com.uk
www.slimeneslim.ifunnyblog.com	ifunnyblog.com
www.nalasquiltshoppe.webs.com	webs.com
www.scammers60955.yuku.com	yuku.com
screener.fidelity.com	fidelity.com
www.smithradiology.openfos.com	openfos.com
www.jandlpowerequipment.stihldealer.net	stihldealer.net
www.fiberglasst.openfos.com	openfos.com
www.j2precision.openfos.com	openfos.com
www.wheelersburgah.vetstreet.com	vetstreet.com
www.umc-net.com.jp	com.jp
www.jeanettegetnailedbyinc.vpweb.com	vpweb.com
www.sarbaliinc.bloombiz.com	bloombiz.com
www.benje.qwestoffice.net	qwestoffice.net
www.decengineering.publishpath.com	publishpath.com
www.incaenterprises.webstarts.com	webstarts.com
www.al.asklocalpages.com	asklocalpages.com
www.roll-lift.nl.com	nl.com
www.usa.philips.com	philips.com
www.crai.com.uk	com.uk
www.photographymarionohio.weebly.com	weebly.com
www.energytransfer.com	energytransfer.com
www.dussaultmoving.webs.com	webs.com
www.jaguardistribution.openfos.com	openfos.com
www.mcallentx.expresspros.com	expresspros.com
www.valleybiosystems.openfos.com	openfos.com
www.balanceheartland.weebly.com	weebly.com
www.higginbothamsrocks.webs.com	webs.com
www.thelocalpaper.logomall.com	logomall.com
www.bergmanridingacademy.weebly.com	weebly.com
www.northwest.williams.com	williams.com
www.home.myfairpoint.net	myfairpoint.net
www.davisprocessservice.webs.com	webs.com
california.att.com	att.com
www.dfinvestmyblog.wordpress.com	wordpress.com
www1.snapon.com	snapon.com
www.northernoil.com	northernoil.com
www.jalpak.jp.com	jp.com
www.foothillsinsuranceservices.lbu.com	lbu.com
www.word-investments-inc.idilogic.aidpage.com	aidpage.com
www.firstavenuerecycling.amlnk.com	amlnk.com
www.comptree88.en.ec21.com	ec21.com
www.edesigncincorporated.vpweb.com	vpweb.com
www.path1.com	path1.com
www.bajaseasyinvestmentcompany.lbu.com	lbu.com
www.richardsonlumber.doitbest.com	doitbest.com
www.personaldiagnostics.com.uk	com.uk
www.ngam.natixis.com	natixis.com
www.teknolr.openfos.com	openfos.com
www.itemprocessing.fiserv.com	fiserv.com
www.videos.rbwe.com	rbwe.com
www.keystoneos.openfos.com	openfos.com
www.divinechildcare.samsbiz.com	samsbiz.com
www.nwinsurance.nationwide.com	nationwide.com
www.bildner-family-foundation-inc.idilogic.aidpage.com	aidpage.com
www.septic-services-nashua.nh-biz.com	nh-biz.com
www.allianceshippinggroup.com.uk	com.uk
www.rbrazz.myshopify.com	myshopify.com
www.dtechgraphics.logomall.com	logomall.com
www.laughingdoginc.vpweb.com	vpweb.com
nebook.com	nebook.com
www.profireextinguishment.wisebuyingmall.com	wisebuyingmall.com
www.primetechint.com.com	com.com
www.answare-inc.weebly.com	weebly.com
imanage.com	imanage.com
www.livewire.publishpath.com	publishpath.com
www.combble.com.uk	com.uk
www.reallyusefulproducts.com.uk	com.uk
www.silkroad.com	silkroad.com
www.pecj.com.jp.com	jp.com
www.acdelco.com	acdelco.com
www.optimatechnologiesgroupinc.webs.com	webs.com
www.2.keiser.com	keiser.com
www.briggsequipment.com.uk	com.uk
www.sharkeytechnologygro.mfgpages.com	mfgpages.com
www.devonmortgagellc.web-loans.com	web-loans.com
www.glrcabs2506.qwestoffice.net	qwestoffice.net
www.mrspitt.radio-dealers.com	radio-dealers.com
www.sheridan-wy.findstoragefast.com	findstoragefast.com
www.drjimschroeder.wordpress.com	wordpress.com
www.empire-avionics-corporation.sbcontract.com	sbcontract.com
www.comrporateone.comop	.comop
www.memry.com	memry.com
www.harveysfellowshiphome.lbu.com	lbu.com
www.hi.asklocalpages.com	asklocalpages.com
www.allcaretreecorp.vzwebsites.com	vzwebsites.com
www.shorelineallergy.yourmd.com	yourmd.com
www.bthservicesinconline.vpweb.com	vpweb.com
www.homeservicebeer.weebly.com	weebly.com
www.richiepharmacal.wisebuyingmall.com	wisebuyingmall.com
www.inc.ominto.com	ominto.com
www.sch.centrahealth.com	centrahealth.com
www.sandiatitle.homestead.com	homestead.com
www.signlanguageinterpreter.webs.com	webs.com
bpy.brookfield.com	brookfield.com
www.amfam.com	amfam.com
www.comlumbus.itex.com	itex.com
www.nevalley.maidbrigade.com	maidbrigade.com
www.denver.citysearch.com	citysearch.com
www.neshertechnologies.openfos.com	openfos.com
www.us070.alphagraphics.com	alphagraphics.com
www.autumnleaflandscaping.com.com	com.com
www.assuredcouriertruckingllc.vpweb.com	vpweb.com
www.nuemanagement.weebly.com	weebly.com
www.md.asklocalpages.com	asklocalpages.com
www.paramounthealthcare.com.uk	com.uk
www.alphamfg.freeservers.com	freeservers.com
www.wi.asklocalpages.com	asklocalpages.com
www.northernscrew.intuitwebsites.com	intuitwebsites.com
www.blastingimpressions.wordpress.com	wordpress.com
www.nj.asklocalpages.com	asklocalpages.com
www.gilbertlogisticsagency.landstaragent.com	landstaragent.com
www.gaylord.househunt.com	househunt.com
www.bancototta.com.uk	com.uk
www.3.officesupply-link.com	officesupply-link.com
www.ramcor-services-group-inc.sbcontract.com	sbcontract.com
www.ctic.com	ctic.com
www.budgetpaydayloans.lbu.com	lbu.com
www.plainwell-mi.findstoragefast.com	findstoragefast.com
www.precision-cable-tennessee-inc.sbcontract.com	sbcontract.com
www.csded.openfos.com	openfos.com
www.diamondtechinc.com.com	com.com
www.adamsadams.com.za	.za
www.opus-design.com.jp	com.jp
www.vqeyecare.optometry.net	optometry.net
www.acculinesurvey.thebluebook.com	thebluebook.com
www.boy.com.jp.com	jp.com
www.wordflowers.weebly.com	weebly.com
www.virginholidays.com.uk	com.uk
us.ishares.com	ishares.com
biostage.com	biostage.com
www.tlcinteractivecare.vpweb.com	vpweb.com
www.integrated-custom-components-inc.sbcontract.com	sbcontract.com
www.carmelmountainvet.vetsuite.com	vetsuite.com
www.mcculloughtrucking.landstaragent.com	landstaragent.com
www.renner-model-services-inc-north-kingstown.jewelleryandgemstones.com	jewelleryandgemstones.com
www.jerseydiagnosticimaging.mfbiz.com	mfbiz.com
www.waysouthphilly.wordpress.com	wordpress.com
www.futaba.com.jp	com.jp
www.randmindustries.homestead.com	homestead.com
www.klinelogistics.com	klinelogistics.com
www.esquireconsultants.com.ke	com.ke
www.asante.com	asante.com
www.threebond.com.jp	com.jp
www.allthingsconsidered.bz.com	bz.com
www.uniontownfirefighters.4t.com	4t.com
www.cyber-z.com.jp	com.jp
www.nsuship.com.jp	com.jp
www.m3civil.vzwebsites.com	vzwebsites.com
www.specialtychem.en.ec21.com	ec21.com
www.spectra-technologies-llc.sbcontract.com	sbcontract.com
www.ultrasonic-sciences.com.uk	com.uk
www.tanakaai.com.jp.com	jp.com
www.stuhooffice.typepad.com	typepad.com
www.lawcoabstract.tripod.com	tripod.com
www.nikkei.com.jp.com	jp.com
www.drepooler7.weebly.com	weebly.com
www.comrbanca.com.com	com.com
www.cozmotv.typepad.com	typepad.com
www.photosportswi.photoreflect.com	photoreflect.com
www.tech1enginesoftampa.webs.com	webs.com
www.comntractors-enterprises.comcastbiz.net	comcastbiz.net
www.lamax-construction.sbcontract.com	sbcontract.com
www.moneygram.com	moneygram.com
www.wa-krapf-inc.sbcontract.com	sbcontract.com
www.hamptoninn3.hilton.com	hilton.com
www.trebellainc.wordpress.com	wordpress.com
www.global.metlife.com	metlife.com
www.lukamineralcosmetics.en.ec21.com	ec21.com
www.drkassir.yourmd.com	yourmd.com
www.comcastbiz.net	comcastbiz.net
www.montrose.k12.sd.us	k12.sd.us
www.dwdgoldsmith.qwestoffice.net	qwestoffice.net
www.datix.com.uk	com.uk
www.nationalfuelgas.com	nationalfuelgas.com
www.wpiobgyn.yourmd.com	yourmd.com
www.one-star-technologies-corporation.sbcontract.com	sbcontract.com
www.smm.com.jp	com.jp
www.tritonenterprisesinc.weebly.com	weebly.com
www.baraholdingsltdcom.bloombiz.com	bloombiz.com
www.clstechnology.wordpress.com	wordpress.com
www.lmc.com.uk	com.uk
www.northsails.com	northsails.com
www.nebula.openfos.com	openfos.com
www.pryormaint.vpweb.com	vpweb.com
www.pharma.bayer.com	bayer.com
www.gva-engineering-llc.sbcontract.com	sbcontract.com
www.isc.publishpath.com	publishpath.com
www.credit-suisse.com	credit-suisse.com
www.price-prints-inc.sbcontract.com	sbcontract.com
www.stpl.com.za	.za
www.downingadr.vpweb.com	vpweb.com
www.plm.automation.siemens.com	siemens.com
www.olynorthwest.webs.com	webs.com
www.ahigherplaneaviation.bravehost.com	bravehost.com
www.valuationtrust.appraiserxsites.com	appraiserxsites.com
www.rybickitrucking.homestead.com	homestead.com
www.trushinetransllc.wordpress.com	wordpress.com
www.pandlscrapironandmetals.lbu.com	lbu.com
www.gfranklin.premierhomemortgage.com	premierhomemortgage.com
www.huffmanchiropractic.chiroweb.com	chiroweb.com
www.rudyslawn.openfos.com	openfos.com
www.fki.com.uk	com.uk
www.allsurgcorp.en.ec21.com	ec21.com
orcinternational.com	orcinternational.com
www.jptrucking.webs.com	webs.com
www.unigas.nl.com	nl.com
www.vipphotography.instaproofs.com	instaproofs.com
www.greenteaminc.wordpress.com	wordpress.com
www.lydiasweatt.sef.mlxchange.com	mlxchange.com
www.hestialab.homestead.com	homestead.com
www.harrismanagementservices.lbu.com	lbu.com
www.jeffrey-howard-inc-dallas.jewelleryandgemstones.com	jewelleryandgemstones.com
www.paradisevaultcompany.ambz.com	ambz.com
www.westfortwayne.abbeycarpet.com	abbeycarpet.com
www.mdgservices.webs.com	webs.com
newscorp.com	newscorp.com
www.tercet.com.uk	com.uk
www.clearwater2.greatflorida.com	greatflorida.com
www.empirebottlingworks.ambz.com	ambz.com
www.fortworth083.alphagraphics.com	alphagraphics.com
www.mib.rbs.com	rbs.com
www.wilsonfab.tripod.com	tripod.com
usa.etfsecurities.com	etfsecurities.com
www.kingmemorialdaynursery.ambz.com	ambz.com
www.winair-instrument-inc.sbcontract.com	sbcontract.com
www.bemco-incorporated.sbcontract.com	sbcontract.com
www.delightmontessorischool.vpweb.com	vpweb.com
www.ne.asklocalpages.com	asklocalpages.com
www.ford.com	ford.com
www.datasystems.comop	.comop
www.fortlauderdale.citysearch.com	citysearch.com
www.lawton-ok-6690.theupsstorelocal.com	theupsstorelocal.com
www.rpmmachineinc.social-circle.com	social-circle.com
www.bombardier.com	bombardier.com
www.tempe004.alphagraphics.com	alphagraphics.com
www.anasazidentallab.ethicalaz.com	ethicalaz.com
www.chrisworkroom.webs.com	webs.com
www.master-matic-inc-osseo-mn.minnesota.usa.machineshopdir.com	machineshopdir.com
www.devon.homeproperties.com	homeproperties.com
www.DGSECompanies.com	dgsecompanies.com
www.china-acm.com	china-acm.com
www.apsadprint.norwood.com	norwood.com
www.hidaka-seiki.com.jp	com.jp
www.therubygroup.sandler.com	sandler.com
www.m-e.aecom.com	aecom.com
www.exxonmobil.com	exxonmobil.com
spc.sinopec.com	sinopec.com
www.homesandland.com	homesandland.com
www.brownfabrications.com.uk	com.uk
www.schumacherlc.openfos.com	openfos.com
www.tpm-llc.vpweb.com	vpweb.com
www.rickfleishman.squarespace.com	squarespace.com
www.samuel-heath.com.uk	com.uk
www.txcorp.com.uk	com.uk
www.fuerza.regole.com	regole.com
educationaldaycare.kiddieacademy.com	kiddieacademy.com
www.wirth-machine-inc-evansville-in.indiana.usa.machineshopdir.com	machineshopdir.com
tech.ubm.com	ubm.com
www.abbeycarpet.com	abbeycarpet.com
www.txstaranimalhosp.vetstreet.com	vetstreet.com
www.lanzatech.com.nz	com.nz
www.loac.vetsuite.com	vetsuite.com
www.stores.healthmart.com	healthmart.com
www.proseed.com.jp.com	jp.com
www.fronterafinancial.autopal.info	autopal.info
www.stlouis.citysearch.com	citysearch.com
www.landservicellc.vpweb.com	vpweb.com
www.bppenterprises.vpweb.com	vpweb.com
www.us123.alphagraphics.com	alphagraphics.com
www.drwjanitorial.intuitwebsites.com	intuitwebsites.com
www.glassport.webs.com	webs.com
www1.blackrock.com	blackrock.com
institutional.fidelity.com	fidelity.com
www.kelly-michener-inc.sbcontract.com	sbcontract.com
www.forgiventransport.vpweb.com	vpweb.com
www.bca.comop	.comop
www.roothomedecor.eventbrite.com	eventbrite.com
www.gunslinger66.lbu.com	lbu.com
www.shoresanhosp.vetsuite.com	vetsuite.com
www.ccvs.state.vt.us	state.vt.us
www.bigpiginc.weebly.com	weebly.com
www.elianetoller.ifunnyblog.com	ifunnyblog.com
www.ncb.comop	.comop
www.deemura.squarespace.com	squarespace.com
www.lynnepetersonphotography.photoreflect.com	photoreflect.com
www.westwindhouseindependentandassistedliving.lbu.com	lbu.com
www.crittercontrol.com	crittercontrol.com
www.irdb.fm.com	fm.com
www.mary-e-carnrick-foundation.idilogic.aidpage.com	aidpage.com
www.alco-machine-company-inc-birmingham-al.alabama.usa.machineshopdir.com	machineshopdir.com
www.aichi-steel.com.jp	com.jp
www.haynsworth.com	haynsworth.com
www.deercreekanimalclinic.vetsourceweb.com	vetsourceweb.com
www.belt.com.com	com.com
www.gotitmaid133.vpweb.com	vpweb.com
www.dlittlestar.homestead.com	homestead.com
www.waldwick.tlechildcare.com	tlechildcare.com
www.americangreetings.com	americangreetings.com
www.totalmsmi.openfos.com	openfos.com
www.1stopsignssafety.openfos.com	openfos.com
www.bluemarbledd.homestead.com	homestead.com
www.biltmoredesignhomes.wordpress.com	wordpress.com
www.usps.com	usps.com
www.virginiacastingindustries.lbu.com	lbu.com
www.webfaq.nwnexus.com	nwnexus.com
www.bluestep.net	bluestep.net
www.gravelymower.com	gravelymower.com
www.jacksonparkphysicians.vpweb.com	vpweb.com
www.daco.com.uk	com.uk
www.sprottphysicalbullion.com	sprottphysicalbullion.com
www.jumpintoreading.publishpath.com	publishpath.com
www.zodiacvanline.webs.com	webs.com
www.comlumbia.citysearch.com	citysearch.com
www.la.asklocalpages.com	asklocalpages.com
www.garfield.printingpartners.com	printingpartners.com
www.cassenacare.com	cassenacare.com
www.calabresegoodarchitects.com	calabresegoodarchitects.com
www.kingstontropicalba.ypgs.net	ypgs.net
www.wightmanfinancial.vpweb.com	vpweb.com
www.comcast.com	comcast.com
www.cuddlebearsdaycarecenter.ambz.com	ambz.com
www.thebluebook.com	thebluebook.com
www.unionfreightservices.com.za.com	com.za.com
www.lawnservicesbylinke.vpweb.com	vpweb.com
www.schuetz.com.jp	com.jp
www.downtowndallas.wordpress.com	wordpress.com
www.msasafety.com	msasafety.com
www.biosciences.dupont.com	dupont.com
www.dirtcheapprinting.weebly.com	weebly.com
www.0catch.com	0catch.com
www.oumconsulting.homestead.com	homestead.com
www.djcrowell.openfos.com	openfos.com
www.southwest-abc-machine-shop-inc.usautos.repair	usautos.repair
www.lawnkeepers.homestead.com	homestead.com
www.peaceriverlandscape.homestead.com	homestead.com
www.slb.com	slb.com
www.hemlockhardware.doitbest.com	doitbest.com
www.secrestdirect.landstaragent.com	landstaragent.com
www.bidbuy.com.jp.com	jp.com
ir.alonusa.com	alonusa.com
www.comastlinesupport.wordpress.com	wordpress.com
www.aaronenterprises.weebly.com	weebly.com
www.metreel.com.uk	com.uk
www.2.theonline401k.com	theonline401k.com
www.twma.com.uk	com.uk
mexicanrestaurantsinc.com	mexicanrestaurantsinc.com
www.fivestarexpress.lbu.com	lbu.com
www.combalt1.fedvendor.com	fedvendor.com
www.comrp.financialengines.com	financialengines.com
www.bobbyromceramictile.ambz.com	ambz.com
www.softtouchmovingandstorage.com	softtouchmovingandstorage.com
www.pemco-electronics-inc.sbcontract.com	sbcontract.com
www.shizuokabank.com.jp	com.jp
www.aimforhopeinc.wordpress.com	wordpress.com
www.tiburon-development-inc.sbcontract.com	sbcontract.com
www.mlb.com	mlb.com
www.innersolar.tripod.com	tripod.com
www.ibogaine.desk.nl.com	nl.com
www.aquitec.com.uk	com.uk
www.qwestoffice.net	qwestoffice.net
www.elopez.sef.mlxchange.com	mlxchange.com
www.chubb.com	chubb.com
www.comcraft.com.jp	com.jp
www.tri-co.radio-dealers.com	radio-dealers.com
www.baratariaanimalhospital.vetsuite.com	vetsuite.com
www.fnbcentralia.com	fnbcentralia.com
www.wilsontractornewberrysc.webs.com	webs.com
www.kodenshi.com.jp	com.jp
www.itb.20fr.com	20fr.com
www.philadelphia.citysearch.com	citysearch.com
www.dikemarineservice.mysite.com	mysite.com
www.executivecar.4t.com	4t.com
sirva.com	sirva.com
www.corp.alderwoodgroup.com	alderwoodgroup.com
www.piledrivers.webs.com	webs.com
www.lantheus.com	lantheus.com
www.weebly.com	weebly.com
www.northdeering.vetsuite.com	vetsuite.com
www.taylorramseyh.openfos.com	openfos.com
www.st.northropgrumman.com	northropgrumman.com
www.myway-logistics.weebly.com	weebly.com
www.ault-james-speed-shop.usautos.repair	usautos.repair
www.dallas.citysearch.com	citysearch.com
www.southpawsvet.vetsuite.com	vetsuite.com
www.coversafe.wpengine.com	wpengine.com
www.fusiongsp.webs.com	webs.com
www.omahaslings.webs.com	webs.com
www.lasvegas.com.kr.com	com.kr.com
www.hummingbirdsailing.webs.com	webs.com
www.land-shaper-inc.sbcontract.com	sbcontract.com
www.robertlbishopdds.vpweb.com	vpweb.com
www.deviabrothers.webs.com	webs.com
www.axistec.com.com	com.com
www.guardian.com.uk	com.uk
www.floridasportstalk.fm.com	fm.com
www.bluegrasspackexpressinc.wisebuyingmall.com	wisebuyingmall.com
www.picturethiskids.photoreflect.com	photoreflect.com
www.process.applications.googlepages.com	googlepages.com
www.zedge.net	zedge.net
www.auto-trol.com	auto-trol.com
www.saint-gobain.com	saint-gobain.com
www.csszaboslawncare.vpweb.com	vpweb.com
www.belugasoftware.comop	.comop
www.sylandscape.webs.com	webs.com
www.fivestarlawncare.wisebuyingmall.com	wisebuyingmall.com
www.mgconsulting.vpweb.com	vpweb.com
www.kidscornerdcc.wordpress.com	wordpress.com
www.savagemortgageser.loandiscovery.com	loandiscovery.com
www.vuteq.com.jp	com.jp
www.boeing.com.uk	com.uk
www.digitalvideosystems.net	digitalvideosystems.net
www.vmc-contracting-inc-woodbridge-va.virginia.usa.homebuildersdirs.com	homebuildersdirs.com
www.shop.americanheritagetrolleytours.com	americanheritagetrolleytours.com
www.aecom.com	aecom.com
www.sejin-c.com.kr	com.kr
www.packer-canning-co-inc.sbcontract.com	sbcontract.com
www.dothanjackson.culliganman.com	culliganman.com
www.fl.asklocalpages.com	asklocalpages.com
www.cf-electronics-inc.sbcontract.com	sbcontract.com
www.web.adventurekidsplaycare.com	adventurekidsplaycare.com
www.rymakservices.webs.com	webs.com
investors.nationalgrid.com	nationalgrid.com
www.kobigrant.metrolistpro.com	metrolistpro.com
www.delnorteambulance.bizland.com	bizland.com
www.bnymellon.com	bnymellon.com
www.altezza.com.uk	com.uk
www.sandler.com	sandler.com
www.dealersenginesales1.webyp.net	webyp.net
quinstreet.com	quinstreet.com
www.hesmet.openfos.com	openfos.com
www.advertising.aol.com	aol.com
www.northway.aaa.com	aaa.com
www.cjbetters.homesandland.com	homesandland.com
www.logomall.com	logomall.com
www.hnhstaffingsolutions.vpweb.com	vpweb.com
site.republicservices.com	republicservices.com
www.hms.cincweb.com	cincweb.com
www.inoac.com.jp	com.jp
www.capital-management-services.pissedconsumer.com	pissedconsumer.com
www.charlottedivision.wrfa.com	wrfa.com
www.2012cfcworkshop.eventbrite.com	eventbrite.com
www.eaglebuildingservices.ambz.com	ambz.com
www.daycareplus.vzwebsites.com	vzwebsites.com
www.smartforwarders.openfos.com	openfos.com
www.eec.homestead.com	homestead.com
www.maconreadymixconcretecompany.amlnk.com	amlnk.com
www.bigbrotherlittlebrothermoving.webs.com	webs.com
www.casarefugiopa.weebly.com	weebly.com
www.ejpaintingfiberglass.homestead.com	homestead.com
www.belair-gold-design-inc-los-angeles.jewelleryandgemstones.com	jewelleryandgemstones.com
www.maderbearingsupplyinc.intuitwebsites.com	intuitwebsites.com
www.mfg.wfadv.com	wfadv.com
www.pankonininsurance.weebly.com	weebly.com
www.clearlake.minutemanpress.com	minutemanpress.com
www.aworldoftravelinc.vacationport.net	vacationport.net
namemedia.com	namemedia.com
www.southwest.nmfn.com	nmfn.com
www.mullaneys.mechanicnet.com	mechanicnet.com
www.isoonline.bizland.com	bizland.com
www.bobierstudio.photoreflect.com	photoreflect.com
www.transorbit.com.jp.com	jp.com
meadowcraft.com	meadowcraft.com
www.clintonvilleanimalhospital.ambz.com	ambz.com
www.psboat.openfos.com	openfos.com
www.gouldeyecare.medem.com	medem.com
www.hawaiipayrollservices.wordpress.com	wordpress.com
www.houseofbethelspiritoftruthinc.webs.com	webs.com
whitehorsefinance.com	whitehorsefinance.com
www.wfis.wellsfargo.com	wellsfargo.com
www.zaldigital.shop.rakuten.com	rakuten.com
www.nelsonappraisals.vpweb.com	vpweb.com
